#############
#P 4#5 3    #
# ####### ###
#     #1  # #
### ### ### #
#        6 0#
### # # # ###
#   #8# #  G#
##### #######
#    7    # #
####### # # #
#9      #2  #
#############
opt 1 1 2 2 1 1 2 2 2 2 2 2 1 1 2 2
hint near 0
bad 1 1 2 2 1 1 2 2 2 2 1 1
corr w near 1
