#########
#5   1#P#
### ### #
#  7   9#
##### ###
#3#6#G 4#
# # ### #
#8 2 0  #
#########
opt 1 1 3 3 1 1
hint near 0
bad 1 1 3 3 3 3 0 0 2 2
corr s near 1
