#########
#  3#G 4#
### ### #
#1 0#  6#
# ##### #
#9#7 P 8#
# # ### #
#2 5  # #
#########
opt 2 2 0 0 0 0 3 3
hint near 3
bad 2 2 0 0 3 3
corr n near 6
