#############
#  3#  8# # #
### # ### # #
# #   #     #
# # ### ### #
#  P  #G#0  #
##### ### ###
#   #  6#   #
### # ### # #
#  9 5#   # #
# # # ##### #
#7#4#1   2  #
#############
opt 2 2 1 1 1 1 1 1 2 2 2 2 2 2 0 0 0 0 3 3 0 0 2 2 0 0 3 3 3 3 1 1
hint near 0
bad 2 2
corr keep going
