#############
#  G#    4  #
# # ### #####
# #0  #     #
# ##### #####
#7 8# #     #
# ### ### ###
#  9# #  5 3#
# ### # # # #
#  6 1  # #P#
# # ### #####
#2#   #     #
#############
opt 0 0 3 3 3 3 1 1 3 3 3 3 3 3 0 0 0 0 0 0 0 0 2 2
hint near 0
bad 0 0 3 3 3 3 1 1 3 3 3 3 3 3 0 0 0 0 2 2
corr n near 7
