#########
#  6#  5#
# # ### #
#7#P    #
### #####
#0 8#2 G#
# # # # #
#3#4 1#9#
#########
opt 1 1 1 1 2 2 0 0 2 2
hint near 2
bad 2 2
corr s near 6
