#############
#4    # #   #
# ### # ### #
#P#3 9# # #0#
##### # # # #
#1          #
### #########
# #G#8 2# # #
# # # ### # #
#5#  6  #   #
# ##### # # #
#      7  # #
#############
opt 0 0 2 2 2 2 1 1 1 1 3 3 1 1
hint near 8
bad 0 0 2 2 2 2 1 1 3 3
corr s near 9
