#############
#           #
##### #######
#5  #       #
### # ### # #
#1#   #G  # #
# ### ##### #
#  P    #4#3#
### # ### ###
#2# #0 8    #
# # ### # # #
#9   6# # #7#
#############
opt 2 2 0 0 0 0 2 2 2 2 1 1 3 3
hint near 4
bad 2 2 1 1 2 2 2 2 0 0
corr n near 0
