#########
#0 2   4#
### # # #
#6# #P#9#
# # ### #
#5 3# #1#
# ### ###
#  G 8 7#
#########
opt 0 0 2 2 1 1 1 1 2 2 1 1 3 3
hint near 3
bad 0 0 2 2 1 1 1 1
corr keep going
