#########
#5#P 4#2#
# ### # #
#6#9   3#
# # ### #
#G#1  # #
# ### # #
#  7 0#8#
#########
opt 3 3 1 1 2 2 1 1 3 3 1 1 2 2 2 2 0 0
hint near 1
bad 3 3 1 1 2 2
corr keep going
