#############
#3  # #8   4#
# # # ##### #
# #6   P  # #
### ### # # #
#2  #0  #G 5#
# ####### ###
#    9 1# # #
##### # ### #
#    7#     #
# ### # ### #
#   # #   # #
#############
opt 2 2 1 1
hint near 5
bad 3 3 3 3 1 1 3 3 1 1 2 2 2 2 2 2
corr w near 8
