#############
#  0#   #   #
### ### ### #
#     #   #9#
### ### # # #
#       #  8#
##### ### ###
# #7#  4#  2#
# # # ### ###
#1     5#P# #
### ##### # #
#3 6#  G    #
#############
opt 1 1 3 3
hint near 5
bad 0 0 0 0 0 0 3 3 1 1 3 3 1 1 1 1 2 2
corr s near 5
