#############
#2 7#       #
### ### # ###
#    1# #0  #
# ### # # ###
# #     #  G#
# # ##### ###
#8#5# #   # #
# # # # # # #
# #   #P#   #
# # # ### ###
#9#6# #3 4  #
#############
opt 0 0 2 2 0 0 2 2
hint near 0
bad 0 0 2 2 0 0 0 0 0 0 3 3 1 1 1 1
corr w near 0
