#########
#  3#5 P#
### # ###
# #G 2# #
# # # # #
#8  #7 4#
# # #####
#1#0 6 9#
#########
opt 2 2 1 1 2 2
hint near 2
bad 2 2 1 1 1 1 3 3 0 0
corr w near 2
