#########
#9#G#P 6#
# # ### #
#5#8 0  #
# ### ###
#1   3 4#
# ### # #
# #  2#7#
#########
opt 2 2 1 1 3 3 3 3 0 0
hint near 8
bad 2 2 1 1 3 3 1 1 3 3 3 3 0 0
corr e near 0
