#########
#5 G#   #
### ### #
#0 1 4#8#
# ##### #
#P 7#3 6#
# # # ###
# #2   9#
#########
opt 0 0 3 3 0 0
hint near 1
bad 3 3 1 1 3 3 0 0 3 3 0 0 0 0 2 2
corr n near 0
