#########
#    P 2#
### ### #
#9    #3#
# # #####
#1#8 7 G#
### # ###
#5 6#0 4#
#########
opt 2 2 1 1 1 1 3 3 3 3
hint near 3
bad 3 3 1 1
corr w near 2
