#############
#8#      9  #
# ### # # ###
#  7# # #   #
### ### #####
#  P        #
# ##### # ###
# #  1  #   #
# ####### ###
#2  #6     4#
# # ### #####
#3#5#  0   G#
#############
opt 2 2 2 2 2 2 1 1 1 1 3 3 1 1 2 2 2 2
hint near 4
bad 2 2 2 2 2 2 1 1 1 1
corr keep going
