#############
#5#4#7# # #8#
# # # # # # #
#    6# #   #
# ### # # ###
#   #  0 G# #
### ##### # #
# # #2 9#   #
# ##### ### #
#3 P  # #   #
# ##### # # #
#    1    # #
#############
opt 3 3 1 1 2 2 2 2 2 2 2 2 0 0 2 2 0 0 3 3 0 0
hint near 0
bad 3 3 1 1 2 2 2 2 2 2 0 0 0 0
corr w near 1
