#########
# #4#9# #
# # # # #
#6 1   8#
### # ###
#5 7#P G#
# # # ###
# #0#2 3#
#########
opt 3 3
hint near 3
bad 0 0 3 3
corr e near 2
