#########
# #  7 1#
# ### ###
#8 P   5#
# # # ###
#2# #3 0#
### ### #
#4 9 G#6#
#########
opt 1 1 1 1 3 3
hint near 3
bad 3 3 1 1 3 3
corr s near 8
