#############
#9        #4#
######### # #
#G   1      #
####### # ###
#  6 5  #   #
# ####### ###
#  2#  0 P  #
# ##### # ###
# #     # # #
### ### # # #
#   #7  #8 3#
#############
opt 0 0 0 0 3 3 3 3 3 3 3 3
hint near 9
bad 0 0 0 0 3 3 1 1 3 3 3 3
corr e near 1
