#############
# #   #    4#
# # # ### # #
#5# # #   #P#
# ### # # ###
#     # #8# #
### # # # # #
# # # # # # #
# ### # # # #
#0#G    #7 9#
# ######### #
#  1 3   6 2#
#############
opt 0 0 3 3 1 1 3 3 1 1 1 1 1 1 3 3 3 3
hint near 0
bad 0 0 3 3 1 1 1 1 1 1 1 1 2 2 1 1 3 3 3 3 3 3 3 3 3 3 0 0
corr e near 8
