#########
#  5  #1#
##### # #
#P 8#2#G#
# # # # #
# #0   6#
# # #####
#4#7 3 9#
#########
opt 3 3 1 1 3 3 3 3 0 0
hint near 1
bad 3 3 1 1 1 1 3 3 3 3
corr e near 0
