#############
# #   #  1  #
# # # ### ###
#  2#  4#   #
####### ### #
#8     6 0 P#
# ###########
#7# #  G# # #
# # # # # # #
#9    #   # #
# ### ### # #
# #5 3#     #
#############
opt 3 3 3 3 3 3 3 3 3 3 1 1 1 1 2 2 2 2 0 0 2 2
hint near 6
bad 3 3 3 3 3 3 3 3 3 3 1 1 1 1 2 2 0 0
corr w near 5
