#########
#4#  0  #
# # ### #
# #2 7# #
# ### # #
#3 8 P#1#
# ### ###
#6#5 9 G#
#########
opt 1 1 2 2
hint near 1
bad 0 0 3 3 0 0 2 2 2 2 1 1 1 1
corr s near 1
