#########
#0 7 8 2#
####### #
#9 4#G#5#
### # # #
#P 1    #
# ##### #
#6 3#   #
#########
opt 3 3 3 3 0 0
hint near 4
bad 3 3 3 3 3 3 0 0
corr n near 1
