#########
#5 G#  8#
# ### ###
#1#6# #0#
# # # # #
#  3 2# #
# # ### #
#9#P 4 7#
#########
opt 0 0 2 2 0 0 0 0 3 3
hint near 5
bad 0 0
corr keep going
