#########
#  4#0 2#
# ### # #
#9#1 3# #
# # # ###
#  8#P  #
# # # ###
#6#5#G 7#
#########
opt 1 1
hint near 5
bad 0 0 2 2 1 1 1 1
corr s near 3
