#########
# #8 5# #
# # # # #
#6 2#P 9#
# ### ###
# #1#0 3#
# # # # #
#  7#G#4#
#########
opt 1 1 1 1
hint near 0
bad 1 1 3 3 1 1
corr s near 0
