#########
#6  #0 P#
### # ###
#1 5#9  #
### # ###
#G#3    #
# ### ###
#2 4 7 8#
#########
opt 3 3 1 1 1 1 1 1 3 3 3 3 0 0
hint near 1
bad 3 3 1 1 1 1 3 3 0 0 3 3
corr s near 3
