#########
#  P#9#3#
# # # # #
#1#0 6  #
# # ### #
#8#2 5#7#
### ### #
#4  #G  #
#########
opt 1 1 3 3 3 3 1 1 1 1 2 2
hint near 5
bad 1 1 1 1 1 1 2 2
corr e near 0
