#########
#9  #G# #
### # # #
#  2 6 3#
# # ### #
# #4 0#8#
### #####
#5 7 P 1#
#########
opt 2 2 0 0 0 0 3 3 0 0
hint near 6
bad 2 2 0 0 3 3
corr n near 4
