#############
#  6#     # #
# ### # # # #
#     # # # #
### ##### # #
#8      # #G#
# # # ### # #
#9#P# # #   #
# ### # #####
#   #7   3#5#
### # # ### #
#  2#4#1   0#
#############
opt 0 0 0 0 2 2 0 0 2 2 2 2 1 1 1 1 1 1 2 2 0 0
hint near 5
bad 0 0 2 2 2 2
corr n near 8
