#############
#8#4       5#
# # # ### # #
#   #6#   # #
### # ### ###
# # #9 P#0#7#
# # ### ### #
#  2# # #   #
# ### ### # #
#   #1  #G#3#
# ### ##### #
#           #
#############
opt 3 3 0 0 0 0 3 3 1 1 1 1 1 1 3 3 1 1 1 1 2 2 2 2 2 2 2 2 2 2 0 0 0 0 3 3 1 1
hint near 3
bad 3 3 0 0 0 0 3 3 1 1 1 1 1 1 3 3 1 1 1 1 2 2 2 2 2 2 2 2
corr keep going
