#########
#P   9 2#
### #####
#    3#4#
# # # # #
# #6#5 1#
# ##### #
#G 0#8 7#
#########
opt 3 3 1 1 2 2 1 1 1 1
hint near 0
bad 3 3 1 1 3 3 1 1 3 3 1 1 2 2
corr w near 3
