#############
# #1 G    # #
# # ####### #
#           #
##### ### ###
#     #2 P#8#
# ####### # #
# #9   3#   #
# ##### # # #
#   #   #4#6#
# ### ### # #
#    0#  5#7#
#############
opt 0 0 3 3 3 3 3 3 0 0 2 2
hint near 1
bad 0 0 3 3 3 3 3 3 3 3 0 0
corr n near 1
