#############
#1#  0#     #
# # # # ### #
#   #     #5#
# ###########
#   #G 3# #4#
# # ### # # #
# #8  #     #
# # # ### ###
# #6#2  #9  #
# # # ##### #
#7#P#       #
#############
opt 0 0 0 0 2 2 1 1 1 1 2 2 2 2 2 2 0 0 3 3 0 0 3 3 0 0 3 3
hint near 3
bad 0 0 0 0
corr keep going
