#########
#7 9   8#
# # #####
#4#3 6 0#
### ### #
#P 2#1 G#
# ### # #
# #   #5#
#########
opt 2 2 0 0 2 2 2 2 1 1
hint near 0
bad 2 2 0 0 0 0 2 2 2 2
corr w near 3
