#############
#3 4#    7 P#
### ##### # #
#       # # #
### ### # # #
#  G#5    #2#
# # ### # ###
# #1  # #9# #
### ### ### #
#   #       #
# # ### ### #
#6#8#   #0  #
#############
opt 3 3 1 1 1 1 3 3 0 0 3 3 3 3 1 1
hint near 1
bad 3 3 1 1 1 1 3 3
corr keep going
