#########
#G 8 2 1#
### #####
#3 9#  0#
### # ###
#7  # #4#
### # # #
#6   P 5#
#########
opt 2 2 0 0 0 0 0 0 2 2
hint near 3
bad 2 2 0 0 0 0 2 2
corr n near 9
