#########
# #5#G 8#
# # ### #
#7 9#4#P#
# # # # #
#1#    2#
# ### # #
#0 6#3# #
#########
opt 0 0 2 2
hint near 4
bad 1 1 2 2 2 2 0 0
corr n near 2
