#########
#3   9#2#
# ##### #
#8   G 7#
##### # #
#4#5  #1#
# # #####
#P 6   0#
#########
opt 3 3 0 0 3 3 0 0
hint near 7
bad 3 3 3 3
corr n near 6
