#########
#0   7# #
# # ### #
#3#2 9 4#
# #######
#5 8   6#
# ### # #
#1  #P#G#
#########
opt 0 0 3 3 1 1
hint near 6
bad 0 0 2 2 2 2 0 0 0 0 3 3 1 1 3 3 3 3
corr e near 6
