#########
#P 1 7 4#
# #######
#   #G 0#
# # # ###
#8#  3 6#
# #######
#  2 5 9#
#########
opt 1 1 2 2 1 1 2 2 0 0
hint near 0
bad 1 1 1 1 1 1 2 2 2 2
corr w near 8
