#########
#6 P#3  #
### ### #
#7#9 5#2#
# # # # #
#0 G#  8#
# # # ###
# #4#1  #
#########
opt 1 1 1 1
hint near 0
bad 1 1 3 3 1 1
corr s near 9
