#########
#5#    8#
# ##### #
#  6 P 0#
# # #####
# #4#9#3#
# # # # #
#7#2 1 G#
#########
opt 2 2 1 1 1 1 3 3 3 3
hint near 1
bad 3 3
corr w near 0
