#########
#4#0   8#
# # #####
#9  #G 7#
# ##### #
#6  #3 P#
# ##### #
#  5 2 1#
#########
opt 0 0 2 2
hint near 3
bad 1 1 2 2 2 2 2 2 0 0 3 3
corr n near 1
