#########
# #6 P# #
# ### # #
#  G 5  #
# ### ###
#0#2 1 3#
### # # #
#9 8#4#7#
#########
opt 1 1 3 3
hint near 2
bad 3 3
corr s near 5
