#########
#3    #6#
##### # #
#G#1#5 8#
# # # # #
#9 7 0#2#
# ### # #
#  4#P# #
#########
opt 0 0 2 2 2 2 0 0
hint near 1
bad 0 0 0 0
corr w near 0
