#############
#P      #   #
##### # # # #
#  0#8#   #9#
# ##### # # #
# #   # # #6#
# ### ### ###
#      4 3 5#
# ####### ###
# #G  #   # #
# # # ### # #
# # #  1 2 7#
#############
opt 2 2 2 2 2 2 1 1 2 2 1 1 1 1 1 1 1 1 3 3 3 3 0 0 3 3
hint near 0
bad 2 2 2 2 2 2 1 1 2 2 1 1 1 1 3 3 3 3 3 3 3 3
corr s near 3
