#########
#4 3 2  #
##### # #
#5 P 7# #
##### # #
#0 8 6#9#
# # # ###
#G# #  1#
#########
opt 3 3 1 1 2 2 2 2 1 1
hint near 0
bad 3 3 1 1 2 2 1 1
corr w near 8
