#########
#0   5 1#
### # ###
#6 8#  9#
# # ### #
#3#G  #P#
##### ###
#7 2   4#
#########
opt 0 0 3 3 0 0 3 3 1 1 1 1
hint near 2
bad 0 0 3 3
corr keep going
