#############
#  7     3  #
######### ###
#  5#8 2  # #
# ### # # # #
#   # #P#   #
### ##### # #
# #G      #9#
# # ### # # #
#  4  # # # #
### ####### #
#  6   1#  0#
#############
opt 0 0 2 2 1 1 1 1 3 3 3 3 3 3
hint near 4
bad 0 0 3 3 1 1
corr w near 2
