#########
#  4 8 P#
# #######
#1  #5  #
# ### ###
#6#7 0#2#
# ### # #
#9 G 3  #
#########
opt 2 2 2 2 2 2 1 1 1 1 1 1 3 3
hint near 3
bad 2 2 2 2 2 2 1 1 3 3
corr s near 1
