#############
#     #1# # #
# ### # # # #
#   #6      #
# ##### #####
#  P# #G    #
# ### ### ###
#4 0   8#  3#
##### ### # #
#5     9#7# #
### ### # ###
#    2# #   #
#############
opt 3 3 0 0 0 0 2 2 2 2 1 1 2 2 1 1
hint near 8
bad 3 3 1 1 2 2 2 2 2 2
corr n near 4
