#########
#0 G#5# #
# ### # #
#6 9   4#
# #######
# #8 1 3#
# ##### #
#  7 2 P#
#########
opt 2 2 2 2 2 2 0 0 0 0 0 0 3 3
hint near 0
bad 0 0 2 2 2 2
corr w near 2
