#############
#4  #7#  9  #
# # # # # # #
# #  G#1# # #
### ##### # #
#  8    # # #
# ######### #
#3 6#P#     #
# ### # ### #
#0    #   # #
# # # ##### #
# #2#5      #
#############
opt 1 1 3 3 3 3 0 0 0 0 2 2 0 0 2 2
hint near 1
bad 1 1 3 3 3 3 0 0 0 0 2 2 0 0 0 0 3 3 1 1
corr w near 8
