#############
#     #  3#8#
##### # ### #
#     #     #
# # # ##### #
#G#2# #   #7#
##### ### # #
#5         4#
######### ###
#    6#1  # #
# # ##### # #
#0#    P   9#
#############
opt 2 2 0 0 0 0 3 3 3 3 0 0 0 0 3 3 3 3 1 1
hint near 2
bad 2 2 0 0 0 0 3 3 3 3 0 0 0 0 0 0 3 3 3 3
corr e near 2
