#############
# #        8#
# # ### # ###
#   #9  # # #
# ######### #
#4     0 1 P#
### #########
#6  #G  # #3#
### # ### # #
#  5        #
##### # # ###
#2    #7#   #
#############
opt 3 3 3 3 3 3 3 3 1 1 1 1 2 2 0 0
hint near 0
bad 3 3 3 3 3 3 3 3 1 1
corr keep going
