#########
#7  #1#G#
# ### # #
#5 2 6 4#
# # #####
#0#  8# #
# # ### #
# #9 P 3#
#########
opt 2 2 0 0 0 0 3 3 3 3 0 0
hint near 1
bad 2 2 0 0 0 0 3 3 0 0
corr e near 6
