#############
#   # # #   #
# ### # # # #
#    9  # #5#
### ### # # #
#  8#G 3 P# #
### ####### #
#     #0  #4#
### # # ### #
#1 6#     # #
# # ### # ###
# #7#   #2  #
#############
opt 3 3 3 3
hint near 3
bad 3 3 0 0 3 3 3 3 1 1 1 1 2 2
corr e near 3
