#########
#     #6#
# ##### #
#7 8 4#1#
### # # #
#3 2#9 P#
# ### ###
#5 G#0  #
#########
opt 2 2 0 0 2 2 1 1 2 2 1 1 3 3
hint near 0
bad 2 2 0 0 2 2 1 1
corr keep going
