#############
#1    #P   6#
# ### ### # #
#2  #0    #9#
# ####### # #
# # #  4  # #
# # ### #####
#8#5#       #
### # ##### #
# #   #    7#
# ### ### ###
#  3  #    G#
#############
opt 2 2 1 1 1 1 3 3 1 1 2 2 2 2 1 1 3 3 1 1 2 2
hint near 7
bad 2 2 1 1 1 1 3 3 1 1 2 2 2 2 1 1
corr keep going
