#########
#9 1 3#4#
### ### #
# #7 G#5#
# # # # #
#6  #0#P#
# # ### #
#8#2    #
#########
opt 1 1 2 2 2 2 0 0 0 0 3 3
hint near 0
bad 0 0 0 0
corr s near 0
