#########
#1 8 3 6#
####### #
#G 5   P#
# ##### #
#4   9# #
### ### #
#  2 0#7#
#########
opt 2 2 2 2 2 2
hint near 1
bad 0 0 2 2 2 2 2 2
corr w near 6
