#############
#8      #6 7#
# ### ### ###
#2  #G 3#   #
# # ### ### #
# #0  # #5  #
##### ##### #
#  P# # #   #
# # # # # # #
#4#9   1# # #
# # # ##### #
# # #       #
#############
opt 1 1 2 2 0 0 0 0 3 3 0 0 3 3 0 0 2 2 2 2 1 1
hint near 3
bad 1 1 2 2 0 0 0 0 3 3 0 0
corr keep going
