#########
#6   3 5#
# ##### #
#P 0 7# #
# ##### #
#9 4 1# #
# ### ###
#2#8 G  #
#########
opt 1 1 2 2 2 2 1 1
hint near 1
bad 0 0 2 2 2 2 2 2 1 1 1 1
corr s near 0
