#########
#7 G#5  #
### ### #
#4 9 3 1#
####### #
#8   P 0#
# # #####
# #2   6#
#########
opt 3 3 0 0 2 2 2 2 0 0
hint near 5
bad 3 3 0 0 0 0 2 2
corr w near 1
