#########
#2 9  #3#
# # # # #
#1# #7 6#
# # ### #
#5#G#0#4#
##### # #
#    8 P#
#########
opt 0 0 0 0 3 3 0 0 3 3 1 1 1 1
hint near 0
bad 3 3 0 0
corr n near 4
