#############
#4# # #  9 1#
# # # # ### #
# #8  #5  #G#
# ### ### ###
# #3    #6# #
# ### # # # #
#7   0#     #
# ### # ### #
# # # #   #P#
# # ####### #
# #2        #
#############
opt 0 0 3 3 0 0 0 0 3 3 0 0 2 2 2 2 1 1
hint near 1
bad 0 0
corr keep going
