#########
#6 9 2 5#
##### ###
# #  1  #
# # # # #
#P 0# #3#
### # ###
#7 4#8 G#
#########
opt 3 3 0 0 3 3 1 1 1 1 3 3
hint near 3
bad 3 3 0 0 3 3 3 3
corr s near 1
