#############
# #9  #   # #
# # ### ### #
# # #8 7#  3#
# # # # ### #
# #  0#1 P  #
# # # ### # #
#   #6 2# # #
# ##### #####
#5  #   #4  #
### ####### #
#      G    #
#############
opt 3 3 0 0 3 3 1 1 3 3 1 1 3 3 1 1 2 2 1 1 2 2 2 2
hint near 2
bad 3 3 0 0 3 3 1 1 1 1 2 2 1 1
corr e near 0
