#########
#  7 3  #
# # #####
#1#8 4  #
# # # # #
#5#G#P#9#
# ##### #
#0  #6 2#
#########
opt 0 0 2 2 1 1
hint near 5
bad 0 0 2 2 0 0 2 2 1 1 1 1 1 1
corr s near 8
