#########
# #P 1 4#
# # #####
#    8 7#
### #####
#2#5 6 G#
# # # # #
#3 0#9# #
#########
opt 1 1 1 1 3 3 3 3
hint near 6
bad 1 1 3 3
corr s near 5
