#########
#1 6 3# #
# ##### #
#7 P 4 0#
# #######
#    8 9#
### # ###
#5 2#G  #
#########
opt 2 2 1 1 3 3 3 3 1 1
hint near 2
bad 2 2 1 1 3 3 1 1
corr e near 2
