#########
#    3#9#
# # # # #
#G#2#7#P#
# # # # #
#4#8#0 6#
# #######
#    1 5#
#########
opt 1 1 3 3 0 0 0 0 3 3 3 3 1 1
hint near 2
bad 1 1 3 3 0 0
corr keep going
