#############
#  6  #1# # #
### ### # # #
# #4#       #
# # ### # # #
#8#    5# # #
# # # # # ###
#7  #3# #  0#
# # ##### ###
# #9#G      #
# ####### ###
#2      #  P#
#############
opt 3 3 0 0 3 3 3 3
hint near 3
bad 3 3 0 0 0 0 0 0 0 0 3 3 1 1 3 3 3 3 1 1 3 3 1 1 1 1 2 2 2 2 2 2
corr e near 0
