#############
#    4#     #
# ### ### # #
#   #   #3#5#
# ##### # ###
# #7   P  # #
# ##### ### #
#2#     #  9#
# ##### ### #
#1 6#   #  0#
### ### # # #
#  8 G#   # #
#############
opt 0 0 3 3 0 0 3 3 3 3 1 1 1 1 1 1 1 1 2 2 1 1 2 2
hint near 8
bad 1 1 1 1
corr n near 3
