#############
#3    #6  #7#
# # ### # # #
# #   # #G#8#
# ##### ### #
#1 0 5#     #
### ##### ###
#     # #   #
### # # # # #
#  2#  4 9# #
# ####### ###
# #P        #
#############
opt 2 2 2 2 2 2 0 0 0 0 0 0 3 3 0 0 0 0 2 2 1 1
hint near 8
bad 2 2 2 2 2 2 0 0 0 0 0 0
corr keep going
