#########
#9#5 2#G#
# # ### #
#  4 0 8#
### #####
# #  6 7#
# ### # #
#1 3 P# #
#########
opt 0 0 3 3 0 0 2 2 2 2 0 0
hint near 2
bad 0 0 2 2
corr e near 6
