#############
#   # #    0#
# ### # #####
#        3  #
### # ##### #
#   # #G    #
# ### ### ###
#   # # #8  #
# ### # #####
#4#    6#  5#
### # # # ###
#2 P#1#7   9#
#############
opt 0 0 2 2 0 0 0 0 0 0 2 2 2 2 2 2 1 1 3 3 3 3
hint near 3
bad 0 0 2 2 0 0 0 0 0 0 2 2 2 2
corr keep going
