#############
# # #2 3  #6#
# # ### ### #
#5      # #1#
####### # # #
#     #     #
##### ### ###
#0#   #G    #
# ### # # ###
#   #  9#  P#
# # # # # # #
#4#7 8# # # #
#############
opt 3 3 0 0 3 3
hint near 9
bad 3 3 0 0 0 0 3 3
corr e near 9
