#########
# #3#P 1#
# # # # #
#8#7 4#6#
# # #####
# #5 9#G#
# # ### #
#0   2  #
#########
opt 1 1 3 3 1 1 1 1 2 2 2 2 0 0
hint near 6
bad 1 1 3 3 1 1
corr keep going
