#########
# #P#G# #
# # # # #
#3 4 8#5#
# # ### #
#7#    0#
### # ###
#2 6#1 9#
#########
opt 1 1 2 2 0 0
hint near 8
bad 1 1 1 1 2 2
corr w near 4
