#########
#2 G   3#
### #####
#0#P#7 4#
# # # ###
# #  8 1#
# ### # #
#9   6#5#
#########
opt 0 0
hint near 2
bad 1 1 3 3 1 1 2 2 2 2 0 0 0 0
corr n near 0
