#############
#     #    1#
### ### # ###
#    G# #5 P#
### ##### # #
#2   9    # #
### #########
#4# # #3 6  #
# # # # ### #
# #     #8  #
# # # #######
#0 7#       #
#############
opt 3 3 1 1 3 3 3 3 3 3 0 0 2 2
hint near 9
bad 3 3 0 0 3 3 1 1
corr s near 5
