#############
#    3#4#   #
# # # # ### #
#1# #  0  #2#
# ####### # #
# #      P#5#
# ### # ### #
# #7  #8   G#
# # # #######
# # #       #
### ##### ###
#6 9  #     #
#############
opt 3 3 1 1 2 2 2 2
hint near 5
bad 3 3 3 3 1 1 1 1 2 2 2 2
corr s near 0
