###########
# #   #   #
# # ### # #
# #     #P#
# # # # ###
#   # # # #
### ### # #
# #  G#   #
# ####### #
#         #
###########
0 0 3 3 1 1 3 3 3 3 1 1 1 1 2 2
