#########
#9#2 P#0#
# # ### #
#    8 1#
### # ###
#G 4#  3#
### # # #
#  7#5#6#
#########
opt 3 3 1 1 1 1 3 3
hint near 4
bad 3 3 1 1 3 3
corr s near 2
