#############
# #  7   8  #
# # ####### #
#  6# # #   #
# ### # # ###
# #  3   9# #
######### # #
#  5   P  # #
### # ##### #
#  0#4  #2  #
# # ### ### #
#G#1#       #
#############
opt 3 3 3 3 1 1 3 3 1 1
hint near 1
bad 3 3 1 1 2 2 1 1 3 3
corr e near 3
