#########
# #0 3  #
# ### # #
# #G  #2#
# # # # #
#6 4#7#5#
# ##### #
#P 1#9 8#
#########
opt 0 0 3 3 0 0
hint near 0
bad 0 0 0 0
corr e near 6
