###########
#   #     #
# # # #####
# #   #  P#
# ####### #
#     #   #
##### ### #
#     #G  #
# ### ### #
# #       #
###########
1 1 1 1 3 3
