#############
#7  # #   # #
# ### ### # #
# #9  #5 P  #
# # # ##### #
# # #1 G    #
# ####### # #
#   #     #3#
# ### #######
#    6# #0 8#
# # ### ### #
# #  4 2    #
#############
opt 2 2 1 1 3 3 3 3
hint near 1
bad 0 0 3 3
corr w near 5
