#########
#  1# # #
### # # #
#4 8 7 9#
# # ### #
#G#2#5# #
### # # #
#6 0#3 P#
#########
opt 0 0 0 0 2 2 2 2 2 2 1 1
hint near 2
bad 0 0 0 0 2 2 2 2 0 0 2 2
corr w near 8
