#############
#   #2#  P#3#
# ### # # # #
# #6#   #  0#
# # # #######
#      1  # #
# # ### ### #
#8#5#    G 4#
##### #######
#        9  #
# # ### #####
# # #    7  #
#############
opt 3 3 1 1 3 3 1 1 2 2 1 1 2 2
hint near 4
bad 3 3 1 1 3 3 1 1 2 2 1 1 3 3 1 1 2 2
corr w near 1
