#############
#    5#P  # #
### ##### # #
#1 2# # #  7#
# ### # ### #
#    6# #   #
##### # # ###
# # #  4  #3#
# # # # ### #
#G    #    8#
# ##### #####
# #  9     0#
#############
opt 2 2 1 1 2 2 1 1 3 3 1 1 3 3 3 3 1 1 3 3 3 3
hint near 1
bad 2 2 1 1 2 2 1 1 3 3 1 1 3 3 1 1 1 1 3 3 3 3
corr e near 4
