#########
#8#6  # #
# ### # #
#4 0  #3#
# # # # #
# #9#P 5#
# ##### #
#1#G 7 2#
#########
opt 3 3 1 1 2 2 2 2
hint near 1
bad 0 0 2 2
corr e near 5
