#########
#4# # #3#
# # # # #
#9  #6 1#
# # # # #
#5#0 P#2#
# #######
#7   G 8#
#########
opt 3 3 0 0 3 3 1 1 1 1 2 2 2 2
hint near 8
bad 0 0
corr e near 0
