#########
#7 2#   #
### # ###
#5 G#P  #
### ### #
#9 3   8#
# ### # #
#6 4#1#0#
#########
opt 3 3 1 1 2 2 2 2 0 0
hint near 2
bad 0 0
corr e near 1
