#########
#0 4#G#7#
# # # # #
# #8 9# #
# ### # #
#3#2 1 5#
### #####
#    6 P#
#########
opt 2 2 2 2 0 0 3 3 0 0 0 0
hint near 4
bad 2 2 2 2 0 0 3 3 3 3 0 0
corr n near 1
