#########
#5# #1 2#
# # # # #
#P 0#4#9#
### # # #
#    8#7#
# # ### #
#6#3#G  #
#########
opt 2 2 1 1 2 2 0 0 0 0 2 2 1 1 1 1 1 1 3 3
hint near 3
bad 2 2 1 1
corr keep going
