#########
#7 G# #8#
### # # #
#9 P#2# #
# ### # #
#5   3#4#
# # ### #
# #1 0 6#
#########
opt 0 0
hint near 7
bad 3 3 1 1 2 2 2 2 0 0
corr n near 2
