#########
#2 G 8  #
# #######
# # #3 4#
# # ### #
#1 P 7 0#
# # #####
#5#  9 6#
#########
opt 2 2 0 0 0 0 3 3
hint near 2
bad 3 3 3 3 0 0 2 2
corr w near 1
