#########
#G#0#3  #
# # ### #
#  P   5#
##### # #
#8 1#6# #
### # ###
#2 4 9 7#
#########
opt 2 2 0 0
hint near 0
bad 0 0
corr w near 0
