#########
#P#G 2#9#
# ### # #
#8 0 6 4#
# # # # #
#1# # # #
# # ### #
#3#7 5# #
#########
opt 1 1 3 3 3 3 0 0 2 2
hint near 0
bad 1 1 3 3 3 3 3 3 0 0
corr n near 6
