#############
# #  0 6#  4#
# # ##### # #
#3     7# # #
# ##### # ###
#  9# #8 2  #
##### # #####
#5  #P  #   #
### # ##### #
# #1      # #
# ### # ### #
#  G  #     #
#############
opt 1 1 1 1 3 3
hint near 1
bad 1 1 2 2 1 1
corr s near 1
