#########
# #G# # #
# # # # #
#  4#5 P#
# # # # #
#9#0 6#1#
### # ###
#2 3#8 7#
#########
opt 3 3 1 1 3 3 0 0 0 0
hint near 4
bad 3 3
corr keep going
