#############
# # #  5    #
# # # ### # #
# # # #   #2#
# # # #######
#   #  0 G 6#
# # ### # ###
# #    8#1#7#
######### # #
# #  P    #9#
# ##### ### #
#  3   4    #
#############
opt 2 2 2 2 0 0 0 0
hint near 0
bad 2 2 1 1 2 2 2 2 0 0 0 0
corr w near 4
