#########
#7#0 9 P#
# ### ###
#G  #2 6#
### # ###
#  3   5#
# ##### #
#1 8#4  #
#########
opt 3 3 1 1 1 1 3 3 0 0 3 3
hint near 7
bad 3 3 1 1
corr keep going
