#############
# #      8 6#
# ### #######
#1  #P G#   #
# ### # ### #
#4    # #   #
# ### ### # #
# #3   0 7# #
# # # #######
# #2# #9# # #
### # # # # #
#  5#       #
#############
opt 2 2
hint near 0
bad 1 1 1 1 2 2 2 2 0 0 2 2 0 0
corr w near 1
