#########
#1 9    #
# # ### #
#P#7 2#3#
##### # #
#  4 G#8#
# # ### #
#0#6 5# #
#########
opt 0 0 3 3 1 1 3 3 1 1
hint near 2
bad 0 0 3 3 3 3 3 3 1 1 1 1 1 1
corr s near 9
