#############
#     #    6#
# ### ##### #
# #9   3#  7#
##### ### # #
#8#    2# #P#
# # ### # ###
#   #  1    #
### # # ### #
#  5# # # # #
# ####### # #
#0     4#G  #
#############
opt 0 0 3 3 1 1 1 1 2 2 1 1 1 1 3 3
hint near 4
bad 0 0 3 3 1 1 1 1 3 3 0 0 3 3 3 3 1 1 1 1 3 3 1 1 2 2 2 2 2 2
corr w near 1
