#############
#5   7     6#
# # ### #####
# #   #  1  #
### ### # ###
#  0 8# #  9#
##### ##### #
#P# #2  #   #
# # # # # ###
#     #G# #3#
# # # ### # #
# #4# #     #
#############
opt 1 1 2 2 2 2 0 0 2 2 1 1
hint near 2
bad 1 1 2 2 2 2 0 0 0 0 3 3 0 0 0 0 2 2 2 2 1 1 2 2 1 1 2 2 1 1 3 3 1 1 1 1 2 2 0 0
corr w near 2
