#########
#1#P   3#
# # # # #
#4  #6#9#
# ### # #
# #5  #G#
# # ### #
#0#2 8#7#
#########
opt 2 2 2 2 1 1 1 1
hint near 7
bad 2 2 1 1 1 1
corr w near 3
