#########
#  0 8#5#
# # ### #
#4#P#1# #
### # # #
#  9   2#
# ### # #
#3 G#6#7#
#########
opt 1 1 3 3 1 1 2 2
hint near 3
bad 1 1 2 2 2 2 1 1
corr e near 9
