#########
# #3 G#8#
# ### # #
#   #2#9#
# # # # #
#6#7 1 4#
# # #####
#P#0 5  #
#########
opt 0 0 0 0 3 3 1 1 3 3 0 0 0 0
hint near 2
bad 0 0 0 0 3 3
corr keep going
