#########
#7#0 8#3#
# # # # #
#5 9#6#G#
### # # #
#P 1#   #
# ##### #
#   #4 2#
#########
opt 3 3 0 0 0 0 3 3 1 1 1 1 3 3 0 0
hint near 3
bad 3 3 0 0 0 0 3 3 1 1
corr keep going
