#########
#9#3#P 0#
# # # ###
#4   7# #
# ##### #
#  G 8 2#
# ### # #
#6 1#5# #
#########
opt 1 1 2 2 2 2 1 1 3 3
hint near 1
bad 1 1 2 2
corr keep going
