#########
#7  #3  #
### # ###
#2 P 4 G#
### ### #
#0#9#  6#
# ### ###
#5   1 8#
#########
opt 3 3 3 3
hint near 4
bad 3 3 0 0 3 3
corr e near 4
