#########
#5#  7#3#
# # ### #
#P 8 G# #
# ### # #
#2 1# #9#
# ##### #
#4 0   6#
#########
opt 3 3 3 3
hint near 7
bad 1 1 3 3
corr e near 2
