#########
#1 6 3#2#
# # ### #
# #9#G 5#
### ### #
#    P 8#
# ### # #
#7#0 4# #
#########
opt 3 3 0 0 2 2
hint near 3
bad 2 2 0 0
corr e near 4
