#########
#  2   0#
# ### # #
#3#8#P#4#
# # #####
#  7  #9#
# # ### #
#5#1 6 G#
#########
opt 0 0 3 3 3 3 1 1 1 1 2 2 1 1 2 2 2 2
hint near 6
bad 0 0 2 2 1 1
corr e near 0
