#########
#G#7 6 8#
# ##### #
#3 5 0 2#
### # # #
#9 4# #1#
### # ###
#  P#   #
#########
opt 0 0 0 0 3 3 0 0
hint near 3
bad 0 0 0 0 2 2 2 2 0 0 3 3
corr e near 5
