#########
#P#4  # #
# # # # #
#  0#5#G#
# ##### #
#  6 8 7#
# ##### #
#3 2#9 1#
#########
opt 1 1 1 1 2 2 2 2 2 2 0 0
hint near 5
bad 1 1 2 2 0 0 2 2 1 1
corr s near 0
