#########
#6 7 1#9#
##### # #
#G#    3#
# # # # #
# #P# #8#
# # # # #
#5 4#2#0#
#########
opt 1 1 2 2 0 0 0 0
hint near 6
bad 0 0 3 3 0 0 2 2
corr s near 4
