#########
#P#4    #
# # #####
#6 5   2#
# ##### #
#3 9#G 0#
# #######
#8 7   1#
#########
opt 1 1 2 2 2 2 2 2 1 1 3 3
hint near 0
bad 1 1 2 2 0 0 2 2
corr w near 5
