#############
#   #  6#   #
# # ### # # #
#1#       # #
### ### #####
#8  # #  7  #
##### # # # #
#G#9#  5#3# #
# # # ### # #
#P    # # # #
# ### # # # #
#  0# #  2#4#
#############
opt 0 0
hint near 8
bad 2 2 2 2 0 0
corr n near 0
