#########
#1 8 4  #
# ### ###
#0#2 9 P#
# # ### #
#3#7#G# #
# # # # #
# #6  #5#
#########
opt 2 2 2 2 1 1 1 1 3 3 0 0
hint near 7
bad 1 1
corr w near 9
