#########
#8#0   2#
# # ### #
#  9 5# #
##### ###
#7#4 6 3#
# # ### #
#  G#1 P#
#########
opt 0 0 3 3 3 3 1 1
hint near 1
bad 3 3
corr n near 1
