#########
#  6 3  #
### # ###
#1 P#9 2#
# #######
#7  #8#G#
# # # # #
# #5 4 0#
#########
opt 2 2 1 1 3 3 1 1 3 3 3 3 0 0
hint near 0
bad 0 0 3 3 3 3
corr w near 1
