#########
#G 4#6#0#
# ### # #
#  3   P#
### # ###
#7 2#5 1#
##### # #
#  9 8# #
#########
opt 2 2 2 2 2 2 0 0
hint near 4
bad 2 2 0 0
corr w near 3
