#########
#P#G 4 3#
# ##### #
#7#9  #0#
# # ### #
#8 5   1#
##### ###
#6     2#
#########
opt 1 1 1 1 3 3 3 3 3 3 0 0 0 0 2 2 2 2
hint near 4
bad 1 1 1 1 3 3 0 0
corr e near 5
