#########
#5#0 6 4#
# # ### #
#  2 G#8#
# ### ###
#P#  7 9#
# # # ###
# #3#1  #
#########
opt 0 0 3 3 3 3
hint near 2
bad 0 0 3 3 0 0 3 3 3 3 1 1
corr e near 2
