#########
#2#P 3  #
# # ### #
# #7#6#4#
# # # ###
#  1 8 9#
# ##### #
#  G 5#0#
#########
opt 1 1 1 1 2 2 1 1 3 3
hint near 1
bad 1 1 1 1
corr keep going
