#########
#    7  #
# # ### #
#1#P#2#6#
### # # #
#3 G#4  #
##### # #
#5 9 8#0#
#########
opt 1 1
hint near 3
bad 0 0 2 2 1 1
corr s near 1
