#############
#  3#G#   # #
# # # ### # #
#5# #4#     #
# # # ### # #
#6#8 1 7  # #
### ##### # #
#     #  2# #
####### ### #
# # #  P#0# #
# # # # # ###
#    9#     #
#############
opt 0 0 2 2 0 0 3 3 3 3 0 0 0 0
hint near 3
bad 0 0 2 2 0 0 0 0 0 0 3 3
corr e near 2
