#########
#4#9#G# #
# # # # #
#8#7 5#6#
# # # # #
#3 2#  P#
####### #
#  1   0#
#########
opt 2 2 0 0 0 0
hint near 5
bad 0 0
corr w near 0
