#########
#2#8 5#3#
# # ### #
#G#1#0  #
# # ### #
#4 P#  7#
### # # #
#  9 6# #
#########
opt 3 3 0 0
hint near 1
bad 1 1 3 3
corr e near 1
