#############
#1  #    3 4#
### ### #####
#   #     # #
### ### ### #
#P   7#5 G# #
### ### ### #
#      8  # #
# ##### # # #
#6  #   #   #
######### ###
#  0   9   2#
#############
opt 2 2 1 1 2 2 2 2 0 0 2 2
hint near 5
bad 2 2 1 1 2 2 2 2 2 2
corr n near 8
