#########
#G 6   4#
##### ###
#9 5 7 8#
# ##### #
#   #3#1#
# # # # #
#P# #0 2#
#########
opt 0 0 0 0 2 2 2 2 0 0 3 3 3 3
hint near 6
bad 0 0 0 0
corr keep going
