#############
#8 5 3 2    #
# # ####### #
#6#1  #  G P#
# # ##### ###
# # # #  9  #
### # ##### #
#    7  # #4#
##### ### ###
#   #       #
# ### ### ###
#0    #     #
#############
opt 3 3
hint near 9
bad 0 0 3 3 3 3 3 3 3 3 1 1 1 1 1 1 2 2 1 1 2 2 2 2 0 0
corr e near 4
