#########
# #7 G 4#
# # # ###
#2 1#6  #
# ##### #
#P#9#8  #
### # # #
#5 3 0# #
#########
opt 0 0 3 3 0 0 3 3
hint near 4
bad 0 0 0 0
corr e near 2
