#############
#4#8 P 2   0#
# # ##### ###
#  7  #     #
### ### ### #
#   #  5#9#6#
# ### ### ###
#  G# #     #
##### # # # #
#       #3# #
# ##### ### #
# #1    #   #
#############
opt 3 3 1 1 1 1 3 3 1 1 2 2
hint near 1
bad 3 3 1 1 1 1
corr keep going
