#########
# #0 9  #
# # # # #
#6# #3#G#
# # #####
#4#7 8  #
# # #####
#1 P 5 2#
#########
opt 0 0 0 0 0 0 3 3 3 3 1 1
hint near 3
bad 0 0 3 3
corr n near 7
