#########
#5  #8 0#
# # # # #
# #  4#9#
# ### ###
#7 6#  2#
##### ###
#G 3 P 1#
#########
opt 3 3 3 3
hint near 3
bad 0 0 0 0 3 3 0 0 3 3 1 1
corr e near 1
