#########
#  4#G 8#
# ### ###
#1 0   P#
### #####
#2 5#7# #
# # # # #
#3#  9 6#
#########
opt 3 3 0 0
hint near 4
bad 3 3 3 3 3 3 0 0
corr n near 0
