#########
#7 3 8 4#
### #####
#0#9 2  #
# # ### #
#G#   #1#
# ### ###
#5   P 6#
#########
opt 3 3 3 3 0 0
hint near 0
bad 0 0 3 3
corr e near 6
