#########
#6#P 0  #
# # ### #
#  3 4#5#
####### #
#1 G 9 8#
# ##### #
#2 7  # #
#########
opt 3 3 3 3 1 1 1 1 2 2 2 2
hint near 1
bad 1 1 2 2
corr e near 0
