#############
#8 1#   #6  #
### # ### # #
#  4#7 3  # #
# # # ### ###
# #9#2#   # #
### # ##### #
#   #       #
### # ##### #
#5 P  # #0# #
# ##### # ###
#G          #
#############
opt 3 3 1 1
hint near 5
bad 0 0 3 3
corr e near 5
