#########
#4 6 P#5#
##### # #
#1# #9 2#
# # # ###
#  3  # #
# ##### #
#0 7 G 8#
#########
opt 1 1 1 1 3 3 3 3 1 1 2 2 2 2
hint near 7
bad 1 1 1 1
corr keep going
