#############
#G  #    6 3#
### ##### # #
#   #7#   #9#
# # # ### ###
# #  0# #   #
# # # # # # #
# #2#   # # #
# # # ### ###
# # #1 5 8  #
# ### # # ###
#  4# # #  P#
#############
opt 3 3 0 0 3 3 3 3 0 0 0 0 3 3 0 0 0 0 3 3
hint near 7
bad 3 3 0 0 0 0 0 0 0 0 0 0 3 3 3 3
corr e near 8
