#########
#P 5#G 6#
# # ### #
#8#3 9 7#
# ### # #
#  4#1# #
# ##### #
#  0#2  #
#########
opt 2 2 1 1 2 2 2 2 0 0 3 3
hint near 5
bad 2 2
corr keep going
