#########
#9  #  5#
### ### #
#  3 G 0#
# # # # #
#6#2#4#P#
# ### ###
#1#8   7#
#########
opt 0 0 3 3
hint near 0
bad 0 0 0 0 3 3
corr e near 0
