#########
#4#8 1#7#
# # ### #
#G P#0  #
### ### #
# #2   6#
# # ### #
#  3#5 9#
#########
opt 2 2
hint near 4
bad 1 1 1 1 2 2 0 0
corr w near 0
