###########
# #  P#G# #
# ### # # #
#       # #
### ### # #
# #   #   #
# # ##### #
#   # # # #
# ### # ###
#         #
###########
1 1 2 2 0 0
