#############
# #1   P  # #
# # ### # # #
#  7#5  #  3#
##### ##### #
# #2  #     #
# # ####### #
#        6# #
### ####### #
# #8      # #
# ### # #####
#  G 9#0   4#
#############
opt 1 1 3 3 1 1 3 3 1 1 1 1 2 2 1 1 3 3
hint near 8
bad 1 1 3 3 1 1 3 3 1 1 1 1
corr keep going
