#########
#5#3 6 P#
# # # ###
#9 2# #4#
### # # #
#1 G# # #
##### # #
#  0 8 7#
#########
opt 2 2 2 2 1 1 1 1
hint near 0
bad 2 2 1 1 1 1 1 1
corr w near 6
