#########
#0 5#  G#
# ### ###
#    9 2#
##### ###
#3 6#P 4#
# ### ###
#7   1 8#
#########
opt 0 0 0 0 3 3
hint near 2
bad 3 3
corr n near 1
