#############
#   #    1  #
### # ### ###
# #  G# # #4#
# # ### # # #
#  3# #P    #
# ### ### ###
#    0  #6 8#
# # ### # # #
#7# # # #5#9#
# # # # ### #
# #   #  2# #
#############
opt 2 2 0 0 0 0 3 3 3 3 1 1
hint near 0
bad 2 2 0 0
corr keep going
