#########
#3 5#4  #
### ### #
#2 P#0#6#
# ### # #
#9#  1 7#
# # # ###
#8  #G  #
#########
opt 3 3 1 1 1 1 2 2 0 0 2 2 1 1
hint near 1
bad 3 3 1 1 1 1 2 2
corr keep going
