#########
#5   3#9#
##### # #
#8 0   P#
# # # # #
#G#7# #6#
# # ### #
#2#1 4# #
#########
opt 3 3 3 3 3 3 1 1
hint near 2
bad 3 3 1 1
corr e near 0
