#########
#6   7  #
### ### #
#  3 G#4#
##### # #
#5 9#0#1#
# # # ###
#P#2 8  #
#########
opt 0 0 3 3 1 1 3 3 0 0 0 0
hint near 0
bad 0 0 3 3
corr keep going
