#########
#G 3 P 5#
####### #
#    7 9#
# #######
#0 1#   #
# # # ###
#4#8 2 6#
#########
opt 2 2 2 2
hint near 3
bad 3 3 1 1 2 2 2 2 2 2 1 1
corr w near 3
