#########
#2 7#5 1#
### # ###
#  8 6 0#
##### # #
#3  # #9#
# ### ###
#G P 4  #
#########
opt 2 2
hint near 3
bad 3 3 0 0 0 0 2 2 2 2
corr w near 4
