#############
#     #6   1#
# ##### # ###
#4  #  G#   #
# # # # #####
# #  2# # # #
# # ### # # #
#5#0  #    7#
##### ### # #
#3    # # # #
##### # # ###
#9 P 8  #   #
#############
opt 2 2 0 0 0 0 3 3 0 0 2 2 0 0 2 2
hint near 6
bad 2 2 0 0 0 0 3 3 0 0 0 0 3 3 0 0 2 2 2 2
corr w near 0
