#############
#4#  2#     #
# ### # ### #
#  9#   # # #
### ### # ###
#  3#6   P# #
# # # # ### #
# #7 8#G    #
# # ### # # #
# #5 0# # # #
### # # # # #
#  1# # # # #
#############
opt 3 3 1 1
hint near 8
bad 3 3 3 3 1 1 3 3 1 1 2 2
corr s near 6
