#########
#5#  3  #
# ### ###
#6 0 2 9#
##### # #
#1 G#P#4#
### # # #
#    7#8#
#########
opt 1 1 2 2 0 0
hint near 0
bad 0 0 0 0 2 2
corr s near 2
