#############
#4 1  # #  9#
### # # # ###
#   # #G#8#6#
### ### # # #
#   # #  3  #
# # # # #####
# #       #2#
# ### ### # #
#7#  0  #   #
# ###########
#  5   P    #
#############
opt 3 3 3 3 3 3 0 0 0 0 0 0 2 2 1 1 2 2 2 2 0 0 0 0
hint near 8
bad 3 3 3 3 3 3 0 0 0 0 0 0 2 2 0 0 0 0 2 2
corr s near 1
