#########
#8  #3#P#
# ### # #
#  7 2 9#
# #######
#1 5 G 6#
### # # #
#4  # #0#
#########
opt 1 1 2 2 2 2 2 2 1 1 3 3 3 3
hint near 2
bad 1 1 2 2 0 0
corr w near 2
