#########
#5 1 G  #
# #######
#2#8 P# #
# ### # #
#4#3   6#
# ### ###
#  0 9 7#
#########
opt 1 1 1 1 2 2 2 2 0 0 0 0 0 0 3 3 3 3
hint near 1
bad 1 1 3 3 0 0
corr s near 3
