#########
#0 2 7 3#
### #####
#P 9#  6#
# ##### #
#  1   G#
### ### #
#8  #4 5#
#########
opt 1 1 3 3 3 3 3 3
hint near 5
bad 3 3 0 0 3 3 3 3
corr s near 0
