#########
#6 5   0#
### #####
#2 3 7  #
### ### #
#1#8  #4#
# # ### #
#P 9 G# #
#########
opt 3 3 3 3
hint near 9
bad 3 3 0 0 0 0 3 3 3 3 1 1
corr e near 9
