#########
#  3#G 8#
# ### ###
#  9#5  #
### # ###
#7 6 4#0#
##### # #
#  P 1 2#
#########
opt 2 2 0 0 0 0 0 0
hint near 3
bad 2 2 0 0 3 3 0 0 3 3 0 0 2 2
corr n near 4
