#############
#    9 6#5  #
### # # ### #
#  8#7# #  2#
# ### # # ###
# # # #   # #
### # # ### #
#1#   # #   #
# # ####### #
#  P 0 3    #
### ### # # #
#4    #G# # #
#############
opt 2 2 2 2 1 1
hint near 3
bad 2 2 2 2 2 2 1 1
corr s near 3
