#########
#4 2 8# #
# ### # #
#7 P#3  #
### # # #
#1  #5#G#
### # ###
#6 0#9  #
#########
opt 2 2 0 0 3 3 3 3 1 1 3 3 1 1
hint near 5
bad 2 2 0 0 3 3 3 3 1 1 1 1
corr e near 3
