#############
#9  #8#    4#
### # # # # #
#2  #  5#6# #
### ### #####
#0       1# #
##### ### # #
#3# # #     #
# # # ### # #
#  G#P# # #7#
### # # ### #
#       #   #
#############
opt 1 1 3 3 0 0
hint near 3
bad 1 1 2 2 0 0
corr e near 3
