#############
#   #2 9#  G#
### ### # ###
#    4 3  # #
####### # # #
#6   1#8#   #
# ### ##### #
#   #5 7 P  #
### # ##### #
#0# #     # #
# # ####### #
#   #       #
#############
opt 2 2 0 0 3 3 0 0 0 0 2 2
hint near 9
bad 2 2 0 0
corr keep going
