#########
#    1#9#
### ### #
#  0 7#3#
### ### #
#2 6 5#G#
### ### #
#4   P 8#
#########
opt 3 3 0 0
hint near 3
bad 2 2 0 0 0 0 3 3
corr e near 5
