#############
#   # # #   #
# ### # # # #
#    4    #P#
####### #####
#G#   #0  #9#
# ### # ### #
#   #       #
### ### ### #
#  8 2 1  # #
# # ### # # #
#3#6#7  #5# #
#############
opt 0 0 3 3 1 1 3 3 1 1 1 1 1 1 3 3 3 3 0 0 3 3 0 0
hint near 0
bad 0 0 3 3 1 1 3 3 3 3 3 3 3 3
corr s near 0
