#############
#7   G 8# # #
### # ### # #
#   # # # # #
### ### # # #
#  4    # #3#
### # ### # #
#2 0#  6    #
# ### ### ###
#1#     #  5#
### # # # # #
#   #9#P# # #
#############
opt 0 0 3 3 0 0 0 0 3 3 0 0 0 0 2 2
hint near 8
bad 0 0 3 3 0 0 0 0
corr keep going
