#########
#9 0#  4#
# ### # #
#2#5 6#1#
# ### # #
#8   3#7#
# ### ###
# #G P  #
#########
opt 2 2
hint near 3
bad 0 0 0 0 2 2
corr w near 3
