#########
#2 3 8#0#
# # ### #
# #6#G# #
### # # #
#5 4 P  #
# ### # #
#9 1# #7#
#########
opt 0 0
hint near 6
bad 2 2 0 0
corr n near 4
