#########
#2 8 3#4#
### ### #
#1#5#  G#
# # ### #
#  0 6 P#
### # # #
#   #9#7#
#########
opt 0 0
hint near 4
bad 3 3 3 3 0 0
corr n near 6
