#########
# #6   8#
# # ### #
#3 5#G#9#
### # # #
# #4 1# #
# ### # #
#P 0 7#2#
#########
opt 3 3 3 3 0 0 0 0
hint near 1
bad 3 3 3 3 0 0 2 2 0 0
corr n near 1
