#########
#2 G 6 4#
##### ###
#P  #3 0#
### ### #
#8#  7#9#
# ### # #
#1     5#
#########
opt 3 3 1 1 3 3 1 1 3 3 0 0 0 0 2 2 0 0 2 2
hint near 2
bad 3 3
corr keep going
