#########
#  0  #4#
# # ### #
#5#3#6#7#
# ### # #
#2  #1 G#
# ### ###
#  9 P 8#
#########
opt 0 0 2 2
hint near 1
bad 3 3 3 3 0 0 2 2
corr n near 1
