#########
#  5 G 6#
# #######
#    4 1#
### # ###
#8 9#7#2#
### ### #
#P   0 3#
#########
opt 3 3 0 0 0 0 2 2 0 0 3 3 3 3
hint near 4
bad 3 3 0 0 0 0
corr keep going
