#############
#  7   6#   #
# ##### # # #
#P  # #5  #8#
### # ### # #
#2 G#     #4#
##### # #####
#  9  #   # #
# ### ### # #
#   #   #0  #
####### #####
#1     3    #
#############
opt 2 2 1 1
hint near 2
bad 0 0 2 2 2 2 2 2 1 1 2 2 1 1 3 3 3 3
corr w near 2
