#############
#8  #     # #
### ### # # #
#G 1 P#3#   #
# # # ### ###
# #4#   #   #
##### # # ###
#   # #0    #
### # ##### #
#6#    9  # #
# # ####### #
#7  #5 2    #
#############
opt 3 3 3 3
hint near 1
bad 1 1 1 1 1 1 3 3 0 0 3 3
corr e near 1
