#########
#1 9   P#
### #####
#  3#2 G#
# ### # #
#7 6 5#0#
####### #
#8   4  #
#########
opt 3 3 3 3 1 1 3 3 1 1 2 2 2 2 0 0 2 2
hint near 0
bad 3 3 3 3 1 1
corr keep going
