#########
#G   P 6#
##### # #
#3 8 0#9#
# ### # #
# #7  #5#
####### #
#1 4 2  #
#########
opt 3 3 3 3
hint near 3
bad 1 1 3 3 3 3 1 1
corr e near 0
