#########
#  5 0 1#
# ### # #
#3 G#6#9#
# #######
#7   4 P#
##### ###
#  8   2#
#########
opt 2 2 2 2 2 2 0 0 3 3
hint near 3
bad 2 2 2 2 2 2 0 0 0 0 3 3
corr e near 3
