#########
#  5 1 7#
### #####
#9#3    #
# # #####
#P 8 G 2#
# ### ###
#  6#0 4#
#########
opt 2 2 2 2
hint near 0
bad 2 2 0 0 2 2
corr w near 8
