#########
#0#  6 5#
# ### ###
#8 2#4  #
### ### #
#G  #9  #
### ### #
#1 P 3 7#
#########
opt 0 0 2 2
hint near 1
bad 3 3 3 3 0 0 2 2
corr n near 1
