#############
#7#9#P 1 8  #
# # ### ### #
#5#6  #  0# #
# # ### ### #
#       #   #
# # # ### ###
# #3# #   # #
##### ##### #
#    2   G  #
### # ### # #
#   #  4# # #
#############
opt 2 2 1 1 1 1 3 3 1 1 1 1 2 2 2 2
hint near 2
bad 2 2 2 2 2 2 1 1 1 1 3 3 1 1 3 3
corr s near 1
