#########
#0 2#4  #
### # ###
#7#    G#
# ### ###
#9   5#8#
### # # #
#6 P#3 1#
#########
opt 0 0 3 3 0 0 3 3
hint near 8
bad 0 0 3 3 0 0 0 0 3 3
corr e near 4
