#########
# #G#9 0#
# # ### #
#5 7 P# #
# ### # #
#4 2#  1#
# ##### #
# #8 6 3#
#########
opt 3 3 0 0
hint near 7
bad 3 3 3 3 1 1 2 2
corr n near 7
