#########
#  G 4 7#
# ##### #
#2#5 6#1#
# ### # #
#  8#3  #
### # ###
#9  #P 0#
#########
opt 0 0 3 3 0 0 0 0 2 2 2 2
hint near 4
bad 0 0 0 0
corr e near 3
