#########
# #  6 5#
# ### ###
#7 3   1#
### ### #
#2 9#0 8#
### ### #
#  P 4#G#
#########
opt 0 0 0 0 2 2 2 2 1 1 1 1
hint near 4
bad 2 2
corr n near 4
