#########
#5# #1  #
# # # ###
#P 8 7#4#
### # # #
#3  #0 G#
# #######
#9 2 6  #
#########
opt 2 2 2 2 1 1 2 2
hint near 0
bad 2 2 1 1
corr w near 8
