#########
#3 1#8 7#
### # # #
# # #6#4#
# # # ###
# #G P#9#
# # # # #
#5 2#  0#
#########
opt 3 3
hint near 2
bad 1 1 2 2 0 0
corr e near 6
