#########
#G  #4 7#
### # ###
#2 9 1#3#
# # ### #
#5#0 P#6#
# # ### #
# #  8  #
#########
opt 2 2 0 0 0 0 2 2
hint near 2
bad 2 2 0 0 2 2
corr n near 9
