#############
#0  #       #
# # ### # ###
# # #G  #   #
### ### # ###
# # # #3#  6#
# # # ### ###
# #5 4   7#2#
# # # ### # #
# # #   #P# #
# ### # ### #
#    8#1 9  #
#############
opt 0 0 0 0 0 0 0 0 3 3 1 1 3 3
hint near 3
bad 0 0 3 3 3 3 3 3 0 0 0 0 0 0 3 3 1 1
corr n near 7
