#########
#1 8 P#5#
### # # #
#3 0#4# #
# # ### #
# #6 G# #
# ##### #
#  2 9 7#
#########
opt 3 3 1 1 1 1 2 2
hint near 4
bad 3 3 1 1 3 3 1 1 1 1 2 2 2 2 2 2
corr s near 0
