#########
# #2 7#3#
# ### # #
#P#G 0# #
# # ### #
# #1 5#6#
# ### # #
#9 4 8  #
#########
opt 1 1 1 1 3 3 3 3 0 0 2 2 0 0
hint near 0
bad 0 0
corr s near 0
