#########
#  5   9#
### ### #
#1 G 4#3#
# ### # #
#0#  P#7#
### ### #
#  6#8 2#
#########
opt 0 0 2 2
hint near 1
bad 2 2
corr n near 4
