#########
#8  #G 0#
# ##### #
#5# #9 7#
# # ### #
#2 1# # #
# # # # #
#4#6 3 P#
#########
opt 0 0 0 0 0 0 2 2
hint near 0
bad 2 2 2 2 0 0 2 2 0 0 0 0 3 3
corr n near 3
