#############
#G# # # #4  #
# # # # ### #
#   #  1#   #
### ### # # #
#   #    6# #
# ### ##### #
#5 2  #     #
### ##### # #
#8   7#0  #3#
##### # ### #
#     #P#  9#
#############
opt 0 0 2 2 0 0 2 2 0 0 0 0 3 3 1 1 3 3 3 3 1 1 3 3 3 3 0 0 2 2 0 0 3 3 0 0
hint near 5
bad 0 0 2 2 0 0 2 2 0 0 0 0 3 3 1 1 3 3 3 3 1 1 3 3 3 3 0 0 2 2 0 0 0 0
corr e near 1
