#########
#8 5#P 3#
# # ### #
# #1 2  #
# ### # #
#7#0 9# #
# ### # #
#4#G 6# #
#########
opt 2 2 1 1 3 3 1 1 1 1 3 3
hint near 0
bad 2 2 1 1 3 3 1 1 3 3
corr s near 9
