#########
#G 1#   #
# # # ###
# #0#7 9#
### ### #
#8 5   6#
### #####
#2 4 P 3#
#########
opt 3 3 0 0 0 0 0 0 3 3
hint near 1
bad 3 3 0 0 3 3
corr n near 5
