#########
#8#  3#1#
# # # # #
#  P#  7#
##### ###
#9#4 0 G#
# ##### #
#  2 5 6#
#########
opt 0 0 3 3 1 1 1 1 3 3
hint near 0
bad 0 0 3 3 1 1 3 3
corr s near 0
