#########
#5 0#9 6#
### ### #
#2 G#  3#
### # ###
#7#8#1  #
# # # ###
#4   P  #
#########
opt 3 3 0 0 0 0
hint near 0
bad 3 3 3 3 0 0
corr n near 4
