#########
#2#4 7 3#
# # # ###
#5 G#8 9#
# #######
#P 6  #1#
# ### # #
#   #  0#
#########
opt 0 0 2 2
hint near 4
bad 2 2
corr n near 5
