#########
#  5 9#2#
### ### #
#3 1   G#
### # # #
#4 0#6#7#
# ### ###
#   #8 P#
#########
opt 2 2 0 0 0 0 3 3
hint near 2
bad 2 2 0 0 0 0 2 2 0 0 3 3
corr e near 1
