#########
#9 7 P 6#
### #####
#2   0#5#
##### # #
#1#4 3  #
# # ### #
#  8#G  #
#########
opt 2 2 1 1 3 3 1 1 3 3 1 1 2 2
hint near 3
bad 2 2 1 1 3 3 1 1 2 2 1 1
corr e near 3
