#########
#2 5 1#9#
### ### #
#P  #G#0#
# ### # #
#4#  7#6#
# ### # #
#    8 3#
#########
opt 1 1 1 1 2 2 2 2 0 0 0 0
hint near 0
bad 1 1 1 1 2 2 2 2 2 2 0 0 0 0
corr n near 8
