#############
#    8    # #
####### ### #
#  7#9 G   P#
### ####### #
# #2 1 4    #
# # # #######
#   #3  #   #
### # # # ###
#5  #6# # # #
# ##### # # #
#   #0      #
#############
opt 3 3 3 3
hint near 4
bad 1 1 3 3
corr e near 4
