#########
#9#5 8#4#
# # ### #
#P 6 2 G#
##### # #
#  7 1# #
# ### ###
#3#    0#
#########
opt 2 2 2 2 2 2
hint near 2
bad 2 2 0 0 2 2
corr w near 6
