#########
#2 9#  G#
### # ###
#8 6 5 4#
# ### ###
#P#1# #3#
# # # # #
#7#0    #
#########
opt 0 0 2 2 2 2 0 0 2 2
hint near 4
bad 0 0 2 2 0 0
corr w near 6
