#############
# #5   0#   #
# # # ### ###
#  1#   #  2#
### ##### # #
#    6#3 G# #
##### # # ###
# #     #9  #
# ### # # # #
#8  # # # # #
# # # # ### #
# #  7#P  #4#
#############
opt 0 0 0 0 0 0 2 2
hint near 3
bad 0 0 0 0 3 3 0 0 3 3 0 0 0 0 2 2 1 1 2 2
corr n near 3
