#########
#5#0  #P#
# ### # #
#7     3#
### # ###
#8 6#4 1#
# # # ###
#2#9#G  #
#########
opt 1 1 2 2 1 1 1 1
hint near 4
bad 1 1 2 2 2 2 1 1 1 1
corr s near 3
