#########
#   #  7#
# # # ###
#5#6#G 9#
# ##### #
#2 8 1#P#
# # # # #
# #0#4 3#
#########
opt 0 0 2 2
hint near 1
bad 1 1 2 2 0 0 2 2
corr n near 1
