#########
#  1 5  #
####### #
#P 4 0 7#
# ### ###
#8#  9  #
# # # ###
#3#6#G 2#
#########
opt 2 2 2 2 1 1 1 1
hint near 2
bad 1 1 1 1
corr w near 4
