#########
#0 9#6# #
### # # #
#4 8#7 2#
### # # #
#P 5#G#3#
# # ### #
#1#     #
#########
opt 3 3 1 1 3 3 3 3 0 0 0 0 2 2 1 1
hint near 3
bad 3 3 1 1 3 3
corr keep going
