###########
#     #G  #
##### # ###
#   #P    #
# # # # # #
# #   # # #
### # # ###
# # # # # #
# ### # # #
#     #   #
###########
2 2 0 0
