#########
#3  #6 P#
# ### ###
# #7 4 G#
# ### # #
#  2 0# #
### #####
#8 5 9 1#
#########
opt 2 2 1 1 3 3
hint near 4
bad 2 2 1 1 1 1 2 2 1 1 3 3 3 3
corr e near 4
