#############
#    7      #
# ### # #####
# #   # #   #
### ####### #
#  2 6#1#G 8#
# ##### # # #
#      5 3# #
# # # ### ###
# #4# #    0#
### ### # ###
#  P  # #  9#
#############
opt 0 0 0 0 2 2 2 2 2 2 0 0
hint near 1
bad 0 0 0 0 3 3 0 0 2 2 0 0 2 2 0 0 2 2 1 1
corr w near 2
