#########
#8 G 4  #
####### #
#  7 9  #
# # #####
#P#2 1 3#
# ##### #
#6 0 5# #
#########
opt 0 0 2 2 2 2 2 2 0 0 3 3 3 3
hint near 4
bad 0 0 2 2
corr keep going
