#########
#9   4  #
### # ###
#G 1#6 3#
####### #
#P 0 2 5#
### ### #
#7 8  # #
#########
opt 2 2 2 2 2 2 0 0 3 3 0 0 3 3 1 1 3 3
hint near 1
bad 2 2
corr keep going
