#############
#4       2  #
### ### #####
# #8  #1    #
# # # ### # #
#  7#P#   # #
# ##### # ###
#0# #6  #   #
# # ### ### #
# #5#3    # #
# # # ##### #
# #  G  #9  #
#############
opt 0 0 3 3 0 0 2 2 2 2 1 1 2 2 1 1 3 3 1 1 1 1 3 3 1 1
hint near 3
bad 0 0 3 3 0 0 2 2 2 2 1 1 2 2 1 1 1 1 2 2 1 1 1 1 3 3
corr e near 1
