#########
#6 9 1  #
# ##### #
#2#G 0#3#
# # # ###
#5# #8  #
# # # ###
#P  #4 7#
#########
opt 3 3 0 0 0 0
hint near 0
bad 0 0 0 0 0 0 3 3 3 3
corr e near 5
