#############
#      9 4  #
# ### # #####
#5  #P#3#   #
# # # # # # #
# # # # #6# #
# # ### # ###
# #1#2#8  # #
# # # # ### #
# #0  #   #G#
# ### # # # #
# #   #7#   #
#############
opt 0 0 2 2 1 1 1 1 1 1 1 1 2 2 1 1 2 2 0 0
hint near 6
bad 0 0 2 2 1 1 1 1 1 1 2 2 0 0 0 0 2 2 1 1
corr s near 8
