#########
#1 6 3 7#
### #####
# #G 4 8#
# ### # #
#5 9 0#2#
# # #####
# #P    #
#########
opt 0 0 2 2 0 0 3 3
hint near 4
bad 0 0 3 3 0 0
corr w near 9
