#########
#   #  2#
# # ### #
# #7 0 5#
##### # #
#9 6 4#1#
# # # ###
#P#8#G 3#
#########
opt 0 0 3 3 3 3 1 1
hint near 3
bad 0 0 3 3 3 3 0 0 3 3 1 1
corr s near 4
