#########
#3 G#5 8#
# ### # #
# #9# # #
# # ### #
#P 4 0 7#
### # ###
#  1#6 2#
#########
opt 0 0 0 0 3 3
hint near 3
bad 3 3 0 0
corr n near 4
