#########
#G 6 3 2#
### ### #
#7 0 4# #
# ##### #
#   #5 8#
# #######
#9 1 P  #
#########
opt 2 2 2 2 0 0 0 0 3 3 0 0 2 2
hint near 6
bad 2 2 2 2 0 0 0 0
corr keep going
