#############
#   # #0#7 3#
# ### # # # #
#  P   5# # #
### ##### ###
#2      #4  #
# ### ### ###
# #6 G  #  9#
# ### ### # #
#   #     # #
# ### ### # #
#1 8# #   # #
#############
opt 1 1 2 2 1 1
hint near 6
bad 1 1 3 3 1 1 1 1 2 2
corr w near 2
