#########
#1 2 3 8#
### ### #
#P 7#4#G#
# ### ###
#0   6 5#
# ##### #
#  9  # #
#########
opt 2 2 0 0 2 2 2 2 1 1
hint near 4
bad 1 1 2 2 2 2 2 2
corr w near 0
