#########
#  1#4#9#
# ### # #
#  7   P#
### ### #
#2 5#8  #
# ### # #
#0 6#G#3#
#########
opt 1 1 3 3 1 1
hint near 3
bad 3 3 3 3 1 1 3 3 1 1 2 2
corr s near 9
