#########
#6  #P#2#
### # # #
#  1 4  #
# # # ###
#0#7#8#3#
# # # # #
#5#9#  G#
#########
opt 1 1 1 1 1 1 3 3
hint near 3
bad 1 1 3 3
corr s near 4
