#########
#2#4#  6#
# # # ###
#5#  3 8#
# # ### #
#P 0 G# #
# # ### #
#1#  7#9#
#########
opt 3 3 3 3
hint near 0
bad 3 3 0 0 3 3 3 3 1 1
corr e near 0
