#########
#G   4#9#
##### # #
#8#  1 2#
# # #####
#6 3 0 5#
### # ###
#P 7#   #
#########
opt 2 2 0 0 0 0 2 2 0 0 3 3 3 3
hint near 8
bad 2 2 0 0 0 0
corr keep going
