#########
#  2   P#
# ### ###
#5 6#4 3#
# # #####
#0#G 9#8#
##### # #
#1   7  #
#########
opt 3 3 3 3 3 3 1 1 2 2 1 1
hint near 0
bad 3 3 3 3
corr keep going
