#########
#  P 3 7#
### ### #
#1 9#0 6#
# ### ###
#G# #  4#
# # # ###
#2#5   8#
#########
opt 1 1 3 3 1 1
hint near 1
bad 2 2 2 2 1 1 3 3 1 1 1 1 3 3 0 0
corr s near 3
