#########
#9 8 G  #
####### #
#5 4 7 P#
# ### ###
#0#3#   #
# # ### #
#2 1  #6#
#########
opt 0 0 2 2
hint near 7
bad 2 2
corr n near 7
