#########
#1#9 G#0#
# # ### #
#5    #8#
##### # #
#3 2 P 6#
# ### # #
#7  #4# #
#########
opt 0 0 3 3 0 0 2 2
hint near 0
bad 0 0
corr keep going
