#############
#  0 G# #5# #
# ##### # # #
#   #    4  #
### # # # ###
# #1 6#P#  2#
# ### # # ###
#   #3# #7#9#
# ### ##### #
#      8    #
# # ### ### #
# # #     # #
#############
opt 0 0 3 3 1 1 3 3 0 0 3 3 0 0 2 2 2 2
hint near 0
bad 0 0 3 3
corr keep going
