#############
#P 2#      0#
### # ##### #
#5 6    #  7#
### # ### ###
#   # #8   1#
### ##### ###
#   #  3# # #
# ##### # # #
#  4  #     #
### ### ### #
#9    #  G# #
#############
opt 2 2 1 1 2 2 0 0 2 2 2 2 2 2 1 1 3 3 1 1 1 1 1 1 3 3 1 1 2 2
hint near 3
bad 2 2 1 1 2 2 0 0 2 2 2 2 2 2 1 1 3 3 1 1 1 1 1 1
corr keep going
