#########
# #4 1 0#
# # #####
#2 P#3#5#
# ### # #
#8 6    #
##### # #
#7 G  #9#
#########
opt 3 3 1 1 2 2 2 2 1 1 3 3
hint near 6
bad 3 3 1 1 2 2
corr keep going
