#############
#  3      # #
# ### ##### #
# #2#9#     #
# # ### #####
#       #  P#
# ##### ### #
#  6  #  7  #
##### ##### #
#G     1 0# #
##### ### # #
#  8    #5#4#
#############
opt 1 1 3 3 3 3 0 0 3 3 3 3 3 3 1 1 2 2 2 2 1 1 3 3 3 3
hint near 6
bad 1 1 3 3 3 3 0 0 3 3 3 3 3 3 1 1
corr keep going
