#############
#2 6# #   # #
# ### ### # #
#     # #5  #
# ### # # ###
# #  G 3    #
####### ### #
# #9   7 P# #
# # ### ### #
#  8  # #  4#
# # # # #####
# # #1#  0  #
#############
opt 3 3 0 0 3 3
hint near 3
bad 3 3 3 3
corr n near 7
