#########
#  6 P 0#
##### ###
#9 4 2  #
# ### ###
#5#  1  #
# # ### #
#3#G 8#7#
#########
opt 1 1 1 1 3 3 1 1
hint near 3
bad 1 1 1 1 2 2 1 1
corr e near 1
