#########
#0 7 5  #
### ### #
#9#G#  P#
# ### # #
#8 4  # #
# #######
#1 2 3 6#
#########
opt 0 0 2 2 2 2 1 1
hint near 4
bad 2 2
corr n near 5
