#########
#1#  5#4#
# ### # #
#G#6 0 P#
# # #####
#3# #2 7#
# # # ###
#8   9  #
#########
opt 3 3 3 3 1 1 1 1 3 3 0 0 0 0
hint near 1
bad 3 3 3 3 1 1
corr keep going
