#############
#P  #5#   # #
# ### # ### #
#2    #     #
# ####### # #
#4 G      # #
# # ### ### #
# #0#3#  9# #
# # # # # # #
# # # #1#6# #
# # # # # ###
# #  7#8#   #
#############
opt 1 1 1 1 2 2
hint near 0
bad 2 2
corr s near 2
