#########
#3 0 2 4#
### # ###
#9 5#G  #
### #####
#6#P   8#
# # # ###
#7  #  1#
#########
opt 0 0 0 0 3 3 1 1
hint near 2
bad 0 0
corr keep going
