#############
#  5 1  #   #
# ##### # ###
# #    9#  2#
### ##### ###
#  4   0 6  #
# ### ### ###
# #   #     #
# ####### ###
#   #    8 7#
# # ####### #
# #G   3#P  #
#############
opt 2 2 0 0 3 3 0 0 0 0 3 3 3 3 3 3 3 3 1 1 1 1 2 2 1 1
hint near 3
bad 2 2 0 0 3 3 0 0 0 0 3 3 3 3 3 3 3 3 1 1 1 1 1 1
corr w near 4
