#########
#7#P 4#9#
# # # # #
#1 5# #6#
# ### # #
#0 G#  2#
##### ###
#  8 3  #
#########
opt 1 1 2 2 1 1 3 3
hint near 0
bad 1 1
corr keep going
