#########
#    G  #
### #####
#3 6#0 7#
# # # # #
#2#  5#8#
# ### ###
#1 9#4 P#
#########
opt 2 2 0 0 2 2 0 0 0 0 3 3
hint near 0
bad 2 2 0 0
corr keep going
