#########
#7 0#2 5#
# # # ###
# #  9 8#
### ### #
#6    #G#
# ### ###
#P#3 1 4#
#########
opt 0 0 2 2 0 0 2 2 2 2 1 1
hint near 4
bad 0 0 2 2 0 0 2 2 0 0 2 2
corr w near 9
