#########
#7 1 5 3#
### #####
#  2#   #
### # ###
#8 0 P# #
# # # # #
#6#9#G 4#
#########
opt 1 1
hint near 4
bad 2 2 2 2 1 1
corr s near 0
