#########
#5#    6#
# # #####
#  7 8 P#
# # #####
#2#G 1  #
# # # ###
#0#4#3 9#
#########
opt 3 3 3 3 1 1
hint near 1
bad 3 3 3 3 3 3 1 1
corr s near 7
