#########
#   #2 3#
# ### ###
#0 1#G 6#
# ##### #
#P 9 7  #
### #####
#8 5 4  #
#########
opt 3 3 3 3 3 3 0 0 2 2
hint near 1
bad 0 0 3 3
corr e near 0
