#########
#9 3 5  #
# ### # #
#7#  P#0#
# # #####
#2#4 1#G#
# ### # #
# #  6 8#
#########
opt 3 3 1 1 2 2 1 1 2 2 0 0
hint near 0
bad 3 3 1 1 2 2
corr keep going
