#########
#3  #5  #
# # # ###
#4#  6 7#
# ##### #
#9 0 G#8#
# # #####
#P#1 2  #
#########
opt 0 0 2 2 2 2
hint near 0
bad 0 0 0 0 0 0 2 2 1 1 2 2 2 2 1 1
corr w near 9
