#########
#5 7#0  #
# # # ###
#1#  8 4#
##### # #
# #6 P# #
# ### # #
#3 2 9#G#
#########
opt 0 0 3 3 1 1 1 1
hint near 9
bad 1 1 2 2
corr n near 6
