#########
#7 1#G 6#
### # ###
#   #5# #
### # # #
#3 0#4  #
# # # # #
#9#8 2#P#
#########
opt 0 0 2 2 0 0 0 0
hint near 1
bad 0 0 2 2 1 1 2 2 0 0 0 0 0 0 2 2
corr n near 4
