#########
#3#P#4 8#
# # # ###
#G     0#
### #####
#2 7 6  #
# ### ###
# #9 1 5#
#########
opt 1 1 2 2
hint near 2
bad 1 1 1 1 2 2
corr w near 7
