#############
#6 8  #     #
# ##### # ###
#  G#1  #9 P#
# ######### #
#   #  3#  2#
### # ### # #
#       # #5#
##### ##### #
#0     7   4#
# # ####### #
# #   #     #
#############
opt 1 1 1 1 1 1 3 3 3 3 3 3 0 0 3 3 0 0 3 3 0 0 2 2
hint near 1
bad 3 3 0 0 3 3 1 1 3 3
corr s near 2
