#########
#7#5 1 0#
# # # ###
#G#P# #2#
# # ### #
#  6 3 8#
# ### # #
#4  # #9#
#########
opt 1 1 3 3 0 0
hint near 7
bad 0 0 2 2 1 1
corr s near 5
