#########
#1 4#G 7#
# ##### #
#    3  #
##### ###
#0#  9 2#
# ### # #
#P 8 5#6#
#########
opt 2 2 2 2 0 0 0 0 2 2 0 0 3 3
hint near 3
bad 2 2 2 2 0 0 0 0
corr keep going
