#########
#  2#1  #
### ### #
#9#4   5#
# ### # #
#8#0 6#3#
# # ### #
#7 G  #P#
#########
opt 0 0 0 0 3 3 1 1 3 3 1 1
hint near 0
bad 0 0 0 0 3 3 3 3
corr s near 1
