#############
#   #4 0  # #
### ### # # #
#7   6 3#G#5#
# ### ### # #
#   # #   # #
##### # ### #
#8    # #   #
# ### ### # #
# #    2  # #
# ##### # ###
#P 1#  9#   #
#############
opt 0 0 0 0 2 2 2 2 0 0 0 0 2 2 0 0 2 2 1 1
hint near 3
bad 0 0 0 0 2 2 2 2 1 1 2 2 2 2 0 0
corr n near 2
