#########
#  0#G  #
# ### # #
#3#7 9# #
# ### ###
#4 1 6 P#
### # # #
#8 2#5# #
#########
opt 2 2 0 0 0 0
hint near 0
bad 2 2 2 2 2 2 0 0 0 0
corr n near 6
