#############
#    5# #1  #
# # # # # ###
#7# #  4#   #
### ##### ###
#   #2   8  #
### ### ### #
#  3# #   # #
# # # # ### #
# #    P  # #
# ### ### ###
#6 0# #  9 G#
#############
opt 2 2 1 1 2 2
hint near 9
bad 0 0 0 0 2 2 2 2 1 1
corr w near 9
