#############
#           #
# # # # # # #
# # #5#3#2#P#
##### ##### #
#     # #   #
### ### #####
#  4#0  #G  #
### ### # # #
#  9 7 6  # #
# ### ##### #
#   #1    #8#
#############
opt 0 0 3 3 3 3 3 3 1 1 1 1 3 3 1 1 1 1 2 2 2 2 2 2 0 0
hint near 0
bad 0 0 3 3 1 1
corr e near 2
