#########
#7 6 5  #
### # ###
#8 2#G 0#
# ##### #
#    3#4#
# # #####
#9#1   P#
#########
opt 2 2 2 2 0 0 2 2 0 0 3 3 0 0 3 3 1 1
hint near 0
bad 2 2 2 2 0 0 3 3
corr w near 1
