#########
#1#9    #
# ### ###
#P 6 4 8#
# ### # #
#7 2#G#5#
# ##### #
#3   0# #
#########
opt 3 3 3 3 1 1
hint near 0
bad 3 3 3 3 3 3 1 1
corr s near 4
