#############
#3   7#     #
# # ### #####
# #8 5# #  1#
# ##### ### #
# # # #2 P 4#
# # # ##### #
#      G#   #
##### ##### #
#    6  #   #
# # ### # ###
# #9#      0#
#############
opt 2 2 1 1 1 1 3 3 1 1 3 3 0 0 3 3 0 0 2 2
hint near 2
bad 2 2 1 1
corr keep going
