#########
#4# #0 7#
# # # ###
#1 6 9  #
####### #
#P 8   2#
# # # # #
# #3#5#G#
#########
opt 3 3 3 3 3 3 1 1
hint near 2
bad 3 3 3 3 1 1
corr e near 2
