#############
# #  8#   #9#
# ### ### # #
#G  #  6#0  #
### # ### ###
#           #
# # # ##### #
# # #5    #4#
####### ### #
#      7  #1#
####### ### #
#2       P#3#
#############
opt 3 3 0 0 0 0 3 3 0 0 3 3 0 0 3 3
hint near 6
bad 3 3 0 0 0 0 3 3 0 0 0 0 0 0 3 3
corr e near 5
