#########
#6#P#2#0#
# # # # #
#8#1 7 4#
# # # ###
#   #5 9#
# ### ###
#   #3 G#
#########
opt 1 1 2 2 1 1 1 1 2 2
hint near 3
bad 1 1 2 2 1 1 2 2
corr s near 5
