#########
#7#1 P# #
# # # # #
#8 3#5 2#
# #######
#  9 6# #
##### # #
#4 0   G#
#########
opt 2 2 1 1 2 2 1 1 3 3 3 3 1 1 3 3
hint near 0
bad 1 1 3 3
corr w near 1
