#############
#0# # #6    #
# # # # # # #
#  5# # # # #
### # # #####
# # #9#8  # #
# # # ### # #
#P     4    #
# ### #######
#   #G 3    #
### ### # ###
#7 2#   #1  #
#############
opt 2 2 2 2 1 1
hint near 3
bad 1 1 2 2
corr w near 7
