#########
# #0 1 4#
# ### # #
#9#8#G# #
# # ### #
#2 7  #5#
### ### #
#  P 6 3#
#########
opt 3 3 3 3 0 0 0 0 0 0 2 2 1 1
hint near 1
bad 0 0 2 2 0 0
corr e near 6
