#########
#7   P  #
##### # #
#G#3 4#9#
# # # ###
#2#0#5# #
# # # # #
#6 8#  1#
#########
opt 1 1 3 3 1 1 1 1 3 3 0 0 0 0
hint near 2
bad 1 1 3 3
corr keep going
