#########
# #3#0  #
# # # # #
#7 8# #6#
### # # #
#P 5 1#2#
# #######
#4 9   G#
#########
opt 1 1 3 3 3 3 3 3
hint near 2
bad 3 3 3 3
corr s near 4
