#########
#  2 1 0#
####### #
#3 G 4# #
# # ### #
# #5   P#
# ### ###
#6#9 8 7#
#########
opt 2 2 2 2 0 0
hint near 2
bad 0 0 0 0 2 2 2 2 2 2
corr w near 7
