#########
#6 P 3 8#
### #####
#1   4  #
# #######
#0#G 9 5#
# ##### #
#    2 7#
#########
opt 1 1 3 3 1 1 1 1 2 2 2 2 2 2 0 0 3 3 3 3
hint near 0
bad 1 1 3 3
corr keep going
