###########
# # # # # #
# # # # # #
#    G    #
### #######
#        P#
### ### ###
# #   #   #
# # # ### #
#   #   # #
###########
3 3 3 3 3 3 0 0 2 2
