#########
#5   6 9#
# #######
#2 0#4#G#
# ### # #
#3#P   8#
# ### ###
#7   1  #
#########
opt 2 2 2 2 0 0
hint near 4
bad 2 2 1 1 3 3 3 3 0 0 0 0 0 0 2 2 2 2 2 2
corr w near 1
