#########
#8 5#2 1#
# ### ###
#P   6#7#
# # # # #
# #4#9 G#
# ### # #
#0  #3# #
#########
opt 2 2 2 2 1 1 2 2
hint near 7
bad 2 2 2 2 0 0 2 2
corr s near 6
