#############
#    9#8    #
# # ####### #
# #7#0#   #4#
# ### # ### #
#   #   #2  #
# # # # ### #
#3#P# #1 G  #
### ### #####
#   # #5 6# #
### # # ### #
#           #
#############
opt 1 1 1 1 2 2 2 2 0 0 0 0 2 2
hint near 1
bad 1 1 1 1 2 2 2 2 0 0 2 2
corr n near 5
