#########
# #5 0 1#
# # ### #
#P   7#G#
##### # #
#  4 6#9#
### #####
#2 8   3#
#########
opt 3 3 0 0 3 3 3 3 1 1
hint near 1
bad 3 3 3 3 1 1 2 2 1 1 3 3 3 3
corr n near 4
