#########
#  0#4 2#
### # # #
#3 G#5# #
# # ### #
# #8 P 6#
# ##### #
#9#1   7#
#########
opt 2 2 0 0
hint near 0
bad 3 3 0 0 0 0 2 2
corr w near 5
