#########
#3#    1#
# # # # #
#2 4#P# #
# ### ###
#0#9 6  #
# # ### #
#7#G#5 8#
#########
opt 1 1 3 3 1 1
hint near 5
bad 0 0 3 3 1 1 3 3 1 1 1 1
corr s near 4
