#########
#2#4 5# #
# # # # #
#G#9#8  #
# ##### #
#1 0#   #
# ##### #
#6 3 7 P#
#########
opt 2 2 2 2 2 2 0 0 0 0
hint near 1
bad 0 0 0 0 2 2 0 0 2 2
corr w near 7
