#########
#8 4    #
### #####
#  0 9 G#
# # #####
# #P#1 3#
### ### #
#6 7 2 5#
#########
opt 0 0 3 3 3 3
hint near 3
bad 1 1 3 3 3 3
corr n near 0
