#########
# # #8 P#
# # ### #
#3 2 0 7#
##### ###
#  4 9 G#
# ##### #
#6#5 1  #
#########
opt 1 1 3 3 1 1 2 2
hint near 7
bad 1 1
corr keep going
