#########
# #3#   #
# # # ###
#4#G 5#8#
# ### # #
#P#0 9 1#
# # # ###
#7 2#  6#
#########
opt 1 1 3 3 0 0 3 3 0 0 2 2
hint near 0
bad 0 0 0 0
corr s near 0
