#############
#9# #       #
# # # ### # #
#8#2  #  6# #
# ####### ###
#  3  #4#  0#
### # # # ###
#G  #P 1  # #
### ### # # #
#   #   #   #
##### # ### #
#     #5#7  #
#############
opt 0 0 3 3 1 1 3 3
hint near 3
bad 2 2 1 1 3 3 1 1 3 3 3 3
corr n near 1
