#########
#4#P 9 6#
# ### ###
#G#  1 5#
# ### ###
# #7   2#
# # # # #
#8 0# #3#
#########
opt 2 2 1 1 1 1 3 3 1 1 3 3 0 0 0 0
hint near 4
bad 2 2 1 1 1 1 3 3
corr keep going
