#############
#       #P#4#
####### # # #
#  9        #
# # # ##### #
# # #G 6 1# #
# ### #######
#2#    5  # #
# # ####### #
# #3  #  8 0#
# ### # #####
#  7#       #
#############
opt 1 1 3 3 3 3 1 1
hint near 6
bad 1 1 3 3 3 3 3 3 1 1
corr s near 9
