#############
#0  #6      #
# # # # # ###
# # # # # # #
### # # ### #
#1 5  #8#  G#
##### # # ###
#2#   #     #
# # # ### # #
#4#7#P  #9# #
# # # # #####
#   # #    3#
#############
opt 0 0 0 0 0 0 0 0 2 2 1 1 1 1 1 1 2 2 0 0 2 2
hint near 8
bad 0 0 0 0 0 0 0 0 2 2 1 1 1 1
corr keep going
