#########
#1 4   0#
### #####
#6#7   9#
# ### ###
#    8#5#
# # # # #
#3#G#P 2#
#########
opt 0 0 2 2 1 1
hint near 3
bad 0 0 0 0 2 2
corr w near 8
