#############
#3 8#     # #
# # # ### # #
# #5    #6  #
# ### # #####
#2  #G#  7# #
# ### ### # #
# #     # #0#
# ####### # #
#1# #     #P#
# # ##### # #
#  9 4  #   #
#############
opt 1 1 3 3 0 0 0 0 0 0 3 3 0 0 3 3 1 1
hint near 2
bad 1 1 3 3 0 0 0 0 0 0 3 3 0 0 3 3 3 3 0 0 3 3 1 1 1 1 2 2
corr s near 5
