#########
#  2 9#P#
##### # #
#4 G  # #
# ##### #
#1 3 0  #
# ### # #
#6#8 5#7#
#########
opt 1 1 1 1 2 2 2 2 2 2 0 0 3 3
hint near 2
bad 1 1
corr keep going
