#########
#9 3#P 0#
# ### # #
#   # #7#
# # # ###
#1#4 2 8#
# # ### #
#6#  G#5#
#########
opt 1 1 1 1 2 2 1 1 3 3
hint near 2
bad 1 1 1 1 2 2 0 0 2 2 1 1 1 1
corr s near 4
