#############
#3#   # #   #
# ### # ### #
#     #8   2#
### # ### ###
#   #9 7  # #
### ##### # #
#  G  #  5  #
### # ### ###
# #1# #     #
# # ### #####
#0  #4 P   6#
#############
opt 0 0 2 2 0 0 0 0 3 3 3 3 0 0 3 3 1 1 1 1
hint near 1
bad 0 0 2 2 0 0 0 0 3 3 3 3
corr keep going
