#############
#  8  #G  # #
### # ### # #
#   #P     6#
### ##### ###
# # #9#     #
# # # # ### #
#3  #2  # #4#
### ### # ###
#   #  1  # #
# # # ### # #
#5# #  7#  0#
#############
opt 2 2 2 2 0 0 3 3
hint near 8
bad 2 2 2 2 1 1 3 3
corr n near 6
