#############
#        5# #
# ### ### # #
#8  # #     #
# ### # #####
#   #1# #  3#
####### # # #
#     # #P#G#
# ### # # ###
# #9#4#     #
### # ### ###
#6   7 2   0#
#############
opt 0 0 2 2 1 1
hint near 3
bad 1 1 3 3 0 0
corr n near 3
