#########
#1 0 P  #
### ### #
#  4#7 3#
# # #####
#G#2#9  #
### # ###
#  5 8 6#
#########
opt 2 2 1 1 2 2 1 1
hint near 2
bad 2 2 2 2
corr s near 0
