#########
#P 6#5 7#
### ### #
#G#4 9  #
# ### ###
#3 8#2 0#
### # # #
#     #1#
#########
opt 2 2 1 1 2 2 1 1 1 1 3 3 0 0 3 3 0 0
hint near 3
bad 2 2 1 1 2 2
corr keep going
