#########
#G 6#  P#
### ### #
#  3 5 7#
### ### #
#  1#0 9#
# # # # #
#4#2# #8#
#########
opt 1 1 2 2 2 2 0 0 2 2
hint near 6
bad 2 2
corr s near 7
