#############
# #P  #   # #
# ### # ### #
#2 5# # # #0#
### # # # # #
#         # #
### # # # # #
#  9# #8#  7#
# # # #######
# #6#     #1#
##### ### # #
#4   G#  3  #
#############
opt 2 2 1 1 1 1 1 1 1 1 1 1
hint near 3
bad 2 2 1 1 1 1 1 1 1 1 2 2 2 2 1 1
corr s near 6
