#########
#0 4#  3#
### # # #
#G 7 8# #
####### #
#5 1 6#2#
# ### # #
#P  #  9#
#########
opt 0 0 3 3 3 3 1 1 3 3 0 0 0 0 0 0 2 2 1 1 2 2 2 2
hint near 0
bad 0 0
corr keep going
