#############
# # #      6#
# # ####### #
# #G# #  2#8#
# # # # # # #
#       #  9#
# # # ### # #
# #0#   # # #
##### ### ###
#   #P#  7 5#
# ##### # # #
#    3  #1#4#
#############
opt 0 0 0 0 3 3 0 0
hint near 0
bad 0 0 0 0 2 2 0 0
corr e near 0
