#############
# #  2#     #
# # ### ### #
#6 1   7#3  #
# ##### ### #
# #  G    #5#
####### #####
# #P  #9# # #
# ### # # # #
# # #     # #
# # # ### # #
#    8#4   0#
#############
opt 2 2 1 1 2 2 0 0 0 0 3 3
hint near 1
bad 2 2 1 1 2 2 0 0 0 0 0 0 3 3 3 3 3 3 1 1
corr e near 7
