#############
# #       # #
# ##### # # #
#3#4#0 6# # #
# # ### ### #
#        G# #
# ####### # #
#8    #  P  #
# # # ### ###
#5#9# #     #
# ##### # ###
#1#  7 2#   #
#############
opt 0 0
hint near 6
bad 2 2 0 0
corr n near 2
