#########
#9  #G#5#
# ### # #
#0#7  #4#
# # # # #
#1  #3 8#
# # # ###
#P# #2 6#
#########
opt 0 0 3 3 0 0 3 3 0 0
hint near 5
bad 0 0 3 3 0 0 3 3 1 1 3 3 0 0 0 0
corr n near 3
