#############
#  2#   #4 8#
# # ### ### #
# # #  1  # #
### ### ### #
#7 6 9#3    #
### ### ### #
#0  # #   # #
# ### # # # #
#     # #P# #
# # # # ### #
# # #  G#  5#
#############
opt 0 0 3 3 1 1 1 1
hint near 5
bad 0 0 3 3 0 0 2 2 2 2 1 1 1 1 1 1 3 3
corr s near 3
