#########
#6 3#1#4#
### # # #
#  2#G  #
# ### # #
#9 0  #7#
##### # #
#P 8  #5#
#########
opt 2 2 2 2 0 0 0 0
hint near 1
bad 2 2 2 2 0 0 3 3 3 3 0 0 2 2
corr n near 0
