#########
#3 6#G#5#
### # # #
#9#0#1 8#
# # ### #
#2  #   #
### # ###
#7 P   4#
#########
opt 3 3 0 0 3 3 0 0 2 2 0 0
hint near 1
bad 3 3 0 0 3 3 0 0 0 0
corr w near 8
