#########
#  3 6#P#
# ### # #
#4#2   9#
### #####
#8 G   1#
##### # #
#0 7 5# #
#########
opt 1 1 2 2 2 2 1 1
hint near 2
bad 1 1 2 2 0 0 2 2 2 2 1 1
corr w near 2
