#############
#   #   #  4#
# ### ##### #
# #1 9#     #
# # # # #####
#   #       #
### ####### #
#P 3#8#  2  #
# # # #######
#5# # #   #7#
# ### ### # #
#  0     6 G#
#############
opt 1 1 1 1 2 2 2 2 2 2 2 2 2 2
hint near 6
bad 2 2 0 0 0 0 2 2 1 1 2 2 2 2 2 2 1 1
corr s near 3
