#############
# #   #6 4  #
# # ### #####
#        8  #
##### # ### #
#     # #   #
##### ### # #
#P#  5 G# # #
# # # # # ###
#0# # # #2 7#
# # # # # # #
#  3#1# # #9#
#############
opt 1 1 1 1 2 2 0 0 0 0 2 2 2 2
hint near 5
bad 1 1 1 1 2 2 0 0 0 0 2 2 0 0 0 0 2 2 1 1
corr w near 5
