#########
#P 1   G#
# # # # #
#2#3# #6#
# #######
#    0 5#
# ##### #
#9 8#7 4#
#########
opt 3 3 3 3 3 3
hint near 6
bad 1 1 1 1 3 3 3 3 3 3
corr e near 1
