#########
#      P#
####### #
#4 2 9#1#
##### # #
#0#3 8 5#
# # #####
#7 6   G#
#########
opt 1 1 1 1 3 3 3 3 1 1 2 2 2 2
hint near 5
bad 1 1
corr keep going
