#############
#   #  0    #
# # ### ### #
# #   #5  #G#
# # ### #####
#7#P   3#   #
# # ### # # #
#2#9#4 8  # #
# # ####### #
# #   # #  6#
### ### # # #
#  1  #   # #
#############
opt 2 2 2 2 0 0 0 0 2 2 2 2 1 1
hint near 5
bad 2 2 2 2 0 0
corr keep going
