#########
#  6 0 3#
# # #####
# #    G#
### ### #
#5 4#7#1#
### # ###
#9 8 P 2#
#########
opt 2 2 0 0 0 0 3 3 3 3
hint near 1
bad 2 2 0 0 0 0 0 0 3 3
corr e near 4
