###########
# #   #   #
# # ### ###
#     #   #
# ### ### #
# #P      #
# ##### ###
#  G#     #
# ### ### #
#   #   # #
###########
2 2 0 0 3 3 3 3 1 1 1 1 2 2
