#########
#P 0#1  #
# # ### #
# #7 6 9#
# # # ###
#2#3#  G#
### #####
#5 4 8  #
#########
opt 3 3 1 1 3 3 1 1 3 3
hint near 9
bad 3 3 1 1 1 1
corr e near 7
