#########
#6#4#1#2#
# # # # #
#7  #P# #
# ### # #
#  G 0#8#
# ### # #
#9#5   3#
#########
opt 1 1 3 3
hint near 0
bad 1 1 1 1 3 3
corr e near 0
