#########
#P 3# #1#
### # # #
#G 6#5 8#
### # ###
#   #7 9#
# # ### #
#0#4   2#
#########
opt 3 3 1 1 2 2
hint near 6
bad 3 3 1 1 1 1 1 1 3 3 3 3 0 0 2 2 0 0
corr w near 6
