#########
#3  #0#9#
### # # #
#6#4 7# #
# ### # #
#2 5 P  #
##### # #
#G 8  #1#
#########
opt 1 1 2 2 2 2
hint near 2
bad 2 2
corr s near 5
