#########
#8# #7#0#
# # # # #
#G   6 4#
### ### #
#5#1#9 3#
# ### ###
#  P   2#
#########
opt 2 2 0 0 2 2 0 0 3 3 3 3 3 3
hint near 5
bad 3 3 0 0
corr w near 1
