#########
#  6#G 3#
# ### ###
#1 5# #9#
# ### # #
#    0 8#
# # # ###
#7#P#2 4#
#########
opt 0 0 2 2 0 0 0 0
hint near 3
bad 0 0 3 3 0 0 0 0 2 2
corr w near 0
