#########
#1#  5 0#
# ### ###
#  8 9#G#
### ### #
#  6 2 7#
# ### ###
#3#P   4#
#########
opt 2 2 0 0 2 2 0 0
hint near 0
bad 2 2 0 0 3 3 0 0
corr w near 2
