#########
#9 0   2#
##### # #
#4   7#5#
# ### ###
#P  #  3#
# ##### #
#8 6#G 1#
#########
opt 0 0 2 2 2 2 1 1 2 2 1 1 3 3
hint near 1
bad 0 0 2 2 2 2 1 1
corr keep going
