#############
#1 9# # #  5#
### # # # ###
# # #  G# # #
# # # ### # #
# #2# #3  #P#
# # # # # # #
#  4  # #   #
# ### # ### #
#6#     #7#8#
# # ### # ###
# #0  #     #
#############
opt 1 1 3 3 0 0 3 3 1 1 1 1 3 3 0 0 0 0 0 0 2 2
hint near 3
bad 1 1 3 3 0 0 3 3
corr keep going
