#########
#8 6#P  #
### # ###
#  3  #G#
### ### #
#7 9 0  #
# ### # #
#1 4#2#5#
#########
opt 1 1 3 3 1 1 2 2 2 2 0 0
hint near 0
bad 1 1 3 3
corr keep going
