#########
#2 1  #3#
# ### # #
#6 G#   #
##### # #
#5 P#0#4#
# # # # #
#8#7  #9#
#########
opt 1 1 3 3 0 0 0 0 0 0 2 2 2 2 1 1 3 3
hint near 1
bad 2 2
corr s near 0
