#############
#3   P G# #8#
# ### ### # #
# # # #2 9# #
### # # ### #
#0      #   #
# # # # ### #
#1# # #     #
##### # # ###
#6    # #  7#
##### # ### #
#    4#   #5#
#############
opt 2 2
hint near 2
bad 1 1 1 1 2 2 0 0
corr w near 2
