#########
#  8 4 7#
####### #
#2 0    #
### #####
#G P   1#
### # # #
#3 5#6#9#
#########
opt 2 2
hint near 2
bad 0 0 2 2
corr w near 0
