#########
#  2# #9#
# ### # #
#7#0   5#
# # #####
#6# #P 3#
# # # ###
#4 1 8 G#
#########
opt 1 1 2 2
hint near 3
bad 2 2
corr s near 3
