#########
#1 3   9#
# ### # #
#G#7 6#2#
####### #
#  5#P  #
# # ### #
#0#8   4#
#########
opt 3 3 0 0 0 0 2 2 2 2 2 2 1 1
hint near 1
bad 3 3 0 0 0 0 2 2 1 1 2 2
corr w near 3
