#########
# #G   6#
# ##### #
#2#P#9 1#
# # # ###
#8 3 5 0#
### ### #
#  4#  7#
#########
opt 1 1 2 2 0 0 2 2 0 0 3 3 3 3
hint near 2
bad 1 1
corr keep going
