#########
#6  #0 1#
### ### #
#7 2   9#
# #######
#4     3#
# ### ###
#P#5 8 G#
#########
opt 0 0 3 3 3 3 1 1 3 3
hint near 3
bad 0 0 0 0 3 3 3 3 3 3
corr e near 4
