#############
# #  8     4#
# # ####### #
#    5 1  #6#
### ### # ###
# # #0# # # #
# # # ### # #
#   #P# #3#9#
### # # ### #
# #2 7 G    #
# # ### # # #
#   #   # # #
#############
opt 1 1 2 2
hint near 7
bad 1 1 3 3 0 0 0 0 0 0 2 2 2 2 1 1
corr w near 7
