#########
# #9#  7#
# # ### #
#  G 3 4#
# ### ###
#2#8 1 6#
##### # #
#5   0#P#
#########
opt 0 0 3 3 0 0 3 3
hint near 3
bad 0 0 3 3 1 1 3 3
corr n near 1
