#############
#2 G#       #
# ### # # ###
#    0# #   #
# ####### ###
#  4   9#   #
# ####### # #
#  6    # # #
# ### ### ###
# #  7  #  3#
### #########
#  8   5 P 1#
#############
opt 3 3 3 3 3 3 0 0 2 2 0 0 3 3 3 3 0 0 0 0 0 0 2 2
hint near 2
bad 3 3 3 3 3 3 0 0 2 2 0 0 3 3 3 3 0 0 2 2
corr n near 4
