#########
#1#  8 9#
# ### # #
#G 7#6#4#
# ##### #
#5#0#   #
# # ### #
#2   3 P#
#########
opt 2 2 2 2 2 2 0 0 0 0
hint near 1
bad 0 0 0 0 0 0 2 2 1 1
corr w near 3
