#############
#   #7      #
# # # # # ###
#6# # #2#0  #
### ####### #
#   #  P#   #
# # # # ### #
# #  8#  9  #
# ####### # #
# #  1   5# #
##### ### # #
#  G 3#  4# #
#############
opt 1 1 2 2 1 1 3 3 3 3 1 1 3 3
hint near 3
bad 3 3 1 1 3 3 0 0 3 3 1 1 1 1
corr s near 2
