#########
# #3#0 P#
# # # ###
#  6#7 4#
### # # #
#5 1 2#9#
### ### #
#  G#  8#
#########
opt 2 2 1 1 1 1 2 2 1 1
hint near 1
bad 2 2 1 1 3 3 1 1 1 1
corr s near 7
