#########
#3 P#  G#
### # ###
#0 9 5  #
##### ###
#4#7 8#6#
# ### # #
#    2 1#
#########
opt 1 1 2 2 0 0 2 2
hint near 5
bad 1 1 2 2 2 2
corr n near 5
