#########
#8 5  #1#
### ### #
# #0 P#7#
# ### # #
# #6#3#G#
# # # # #
#2 9 4  #
#########
opt 1 1 1 1 3 3 0 0
hint near 3
bad 1 1 1 1 2 2 0 0
corr e near 4
