#########
#4 0 G#3#
### ### #
# #5 8  #
# ##### #
#2 6 1  #
### # ###
#9 P#7  #
#########
opt 0 0 2 2 2 2 0 0 3 3 3 3 0 0 2 2
hint near 0
bad 0 0 2 2
corr keep going
