#########
#  P   8#
### # # #
#G 9#2#1#
# ##### #
#0#  7  #
# ### ###
#5 3#4 6#
#########
opt 1 1 3 3
hint near 0
bad 2 2 2 2 1 1 1 1 3 3 3 3
corr s near 9
