#########
#   #9#5#
# ### # #
#G 3# #6#
# ### # #
#7#1   8#
# ### # #
#0 2 P#4#
#########
opt 2 2 2 2 0 0 0 0
hint near 3
bad 0 0 2 2
corr w near 2
