#########
#9 3 P  #
# #######
#2#5 0 1#
# ### ###
# #G#6# #
# # # # #
#4 7   8#
#########
opt 3 3 3 3 1 1 1 1 1 1 2 2 0 0
hint near 5
bad 3 3
corr keep going
