#########
#4 0   9#
# ### # #
#2#P  #3#
# # ### #
#7#1 8#6#
# ##### #
# #  G 5#
#########
opt 3 3 0 0 3 3 1 1 1 1 1 1 2 2
hint near 5
bad 1 1 3 3
corr e near 0
