#########
#P 1#8 9#
### # ###
#5 0    #
### ### #
#4 G 2# #
# # # # #
#3# #7#6#
#########
opt 2 2 1 1 1 1
hint near 0
bad 2 2 1 1 2 2 2 2 1 1
corr s near 0
