#########
#1     P#
### # # #
#8#G# #7#
# ### ###
#3#5 4#2#
# # # # #
#0  #9 6#
#########
opt 2 2 2 2 1 1
hint near 5
bad 2 2 1 1 1 1 2 2 1 1 2 2 0 0
corr w near 1
