#########
#0#6  # #
# ### # #
#G 3#8#9#
### # # #
#  7 P 2#
# # # ###
#4#5#1  #
#########
opt 2 2 0 0 2 2
hint near 0
bad 0 0 0 0 2 2
corr w near 1
