#########
#    3#8#
# # ### #
#9#5#G 0#
# # # ###
#6#7   1#
# # ### #
#4#2#  P#
#########
opt 0 0 2 2 0 0
hint near 0
bad 0 0 2 2 2 2 0 0 0 0 3 3
corr n near 1
