#########
#3     4#
### # ###
#9 7#8 1#
# #######
#P#2# #5#
# # # # #
#0 G 6  #
#########
opt 1 1 3 3
hint near 0
bad 0 0 3 3
corr s near 0
