#########
#0 1   3#
##### ###
#  2   5#
##### ###
#4#G 7 6#
# # ### #
#8 9#P  #
#########
opt 3 3 0 0 2 2 2 2
hint near 2
bad 3 3 0 0 2 2 0 0 0 0 2 2
corr w near 7
