#############
#3#   #P#  5#
# # ### ### #
#  6#   #   #
# ### ### # #
#   #0#   # #
### # # ### #
# #     #9  #
# ### ##### #
#7  #2 1 8# #
# # # ### # #
# #    4#G# #
#############
opt 1 1 3 3 1 1 1 1 1 1 2 2 2 2 1 1
hint near 4
bad 1 1 3 3 1 1 1 1 2 2 0 0 2 2 0 0 2 2 1 1 1 1 1 1 1 1
corr s near 0
