#########
#P     1#
# ### # #
# #9 0#8#
##### ###
#2 7 5# #
### ### #
#4 6 3 G#
#########
opt 3 3 3 3 1 1 1 1 2 2 1 1 3 3 3 3
hint near 3
bad 3 3 3 3 1 1 1 1
corr keep going
