#############
# #        4#
# ### ### ###
#6   P#5#7  #
# ### # ### #
#   #8    # #
# ### ##### #
#   # #G# #9#
##### # # ###
#2  #  3   1#
# # ##### # #
# #       #0#
#############
opt 1 1 1 1 1 1 2 2 0 0
hint near 3
bad 1 1 1 1
corr keep going
