#########
#G 3#  7#
# ### ###
#9# #6 P#
# # ### #
#4 1 0 2#
# #######
#    5 8#
#########
opt 1 1 2 2 2 2 2 2 0 0 0 0
hint near 3
bad 1 1 2 2 2 2 0 0
corr w near 1
