#########
#6#G# #8#
# # # # #
#P 9   1#
##### ###
#  0#4 3#
### # ###
#7 2 5  #
#########
opt 3 3 0 0
hint near 6
bad 3 3 3 3 1 1 1 1 2 2 0 0
corr n near 9
