#########
# #4 7# #
# # # # #
#6#3# #0#
# ### # #
#5 2 G#8#
# ##### #
#P 9 1  #
#########
opt 0 0 2 2 2 2
hint near 1
bad 2 2 2 2 2 2 0 0 0 0
corr n near 5
