#########
#9 7#G 8#
### # ###
#P 1 4#6#
# # ### #
#0#  2  #
# # # ###
#5# #3  #
#########
opt 3 3 3 3 0 0
hint near 4
bad 3 3 1 1 3 3 3 3 0 0
corr e near 1
