###########
#   #     #
# ##### ###
#   #     #
# # ##### #
# # #     #
### # #####
#G#      P#
# ##### ###
#         #
###########
3 3 1 1 3 3 3 3 3 3 0 0
