#############
#    3   9  #
# ### # ### #
#2#  1# #   #
### ### #####
#7 6#5#    P#
# # # # ### #
#4#8  #G  # #
### #########
#  0  # # # #
# ### # # # #
#   #       #
#############
opt 3 3 3 3 1 1
hint near 5
bad 3 3 3 3 0 0 0 0 3 3 1 1 3 3 1 1 1 1
corr s near 5
