#############
# #   #   #P#
# # ##### # #
#7# #G 1# # #
# # ### # # #
#         # #
# ######### #
# #    6    #
# ### # # ###
# #  0#5#  2#
# # # ### ###
#9 3#4  #8  #
#############
opt 1 1 1 1 1 1 3 3 3 3 3 3 1 1 3 3 1 1 3 3 0 0 0 0 0 0 2 2 2 2 2 2 0 0 3 3
hint near 1
bad 1 1 1 1 1 1 3 3 3 3 3 3 1 1 3 3 1 1 3 3 0 0 0 0 0 0 0 0
corr w near 7
