#########
#P#   #4#
# ### # #
#5 8 3 7#
### #####
#9 6 0 1#
# # ### #
# #G 2# #
#########
opt 1 1 2 2 1 1 1 1
hint near 2
bad 1 1 2 2 1 1 2 2 2 2 1 1
corr s near 6
