#########
#  P 1 3#
### #####
#4 0#9#G#
# # # # #
#7#2 6  #
### #####
#    8 5#
#########
opt 1 1 1 1 3 3 3 3 0 0
hint near 3
bad 3 3
corr s near 0
