#########
#5  #G#8#
### # # #
#  0#  6#
# ##### #
#4 9 1#7#
### # # #
#2 3#P  #
#########
opt 3 3 0 0 0 0 2 2 0 0
hint near 8
bad 0 0
corr e near 1
