#########
#4 5#9 0#
### # ###
#G  #6 8#
### # ###
#P#3    #
# # # ###
#1 2#  7#
#########
opt 1 1 3 3 0 0 0 0 2 2
hint near 4
bad 1 1 3 3 0 0 3 3 0 0
corr n near 3
