#########
#2 0 P G#
### #####
#  9 6  #
### # ###
#8 7#4 1#
### # ###
#3 5#   #
#########
opt 3 3
hint near 0
bad 2 2 1 1 3 3
corr e near 0
