#########
#3 P G 8#
# # #####
#5#  4 2#
### #####
#7   0  #
# # ### #
#6#  1#9#
#########
opt 3 3
hint near 4
bad 1 1 1 1 3 3
corr e near 3
