#########
#7#  0  #
# ### # #
#P 9#2#G#
### # ###
#8 6   3#
# # # # #
#4#5# #1#
#########
opt 3 3 1 1 3 3 0 0 0 0 3 3 1 1
hint near 2
bad 3 3 1 1 3 3 3 3
corr n near 2
