#########
#0#7 2 4#
# # ### #
#G  #1 8#
##### ###
#6  #  9#
# # # ###
# #5 3 P#
#########
opt 2 2 0 0 0 0 3 3 0 0 2 2 2 2 1 1 2 2
hint near 0
bad 2 2 0 0 0 0
corr keep going
