#########
#8  #0 5#
# ### # #
#4 2#7# #
### # # #
#6#1#P#G#
# # # ###
#    3 9#
#########
opt 0 0 0 0 2 2 1 1 1 1
hint near 9
bad 1 1 2 2
corr n near 1
