#########
#9#4#0 6#
# # # ###
#8 P   2#
# # # ###
#1# #3 G#
##### ###
#5 7    #
#########
opt 3 3 1 1 3 3
hint near 2
bad 3 3 3 3
corr s near 0
