#############
#7   9#6    #
##### ### # #
# #  1    #4#
# ### ### ###
#G      #3  #
# # # # #####
#0# # #     #
# ##### ### #
# #5#   #  8#
# # # ##### #
# #2   P#   #
#############
opt 3 3 0 0 2 2 0 0 0 0 3 3 3 3 3 3
hint near 0
bad 3 3 0 0 2 2 0 0 0 0 3 3 0 0 0 0 3 3 3 3
corr e near 1
