#########
#2 4 9#7#
# # ### #
#6#3 P 0#
### # ###
# #5#G  #
# # # # #
#1  #8# #
#########
opt 1 1
hint near 5
bad 2 2 0 0 3 3
corr s near 0
