#########
#3 7 5#G#
### ### #
#8 0 4 2#
### # # #
#  9# #1#
# # # # #
# #6#P# #
#########
opt 0 0 0 0 3 3 0 0
hint near 2
bad 0 0 0 0 2 2 0 0 3 3
corr e near 4
