#########
#G 1   P#
### #####
#   #3 6#
# ### ###
#4#9 7 2#
# # # ###
#0  #8 5#
#########
opt 3 3 3 3 3 3
hint near 1
bad 3 3 3 3 1 1 3 3
corr e near 1
