#########
#0    #9#
# ### # #
#   #G 4#
### #####
#3 5 1 6#
##### # #
#8 2 7#P#
#########
opt 0 0 3 3 3 3 0 0 3 3 0 0 2 2 2 2 1 1
hint near 1
bad 0 0 3 3 3 3 0 0
corr keep going
