#############
# #  5#     #
# # # # #####
#3  #2    # #
### ####### #
#  7  #6   8#
### ### # ###
# #    G#   #
# ### ### ###
#P    #    9#
### ####### #
#0  #1   4  #
#############
opt 2 2 2 2 0 0 2 2
hint near 6
bad 2 2 2 2 0 0 3 3 0 0 0 0 0 0 2 2 1 1 2 2
corr w near 1
