#########
#4 8#P#0#
# ### # #
#6   2 1#
##### # #
#5 G 3# #
# ### ###
#  7#9  #
#########
opt 1 1 1 1 2 2
hint near 3
bad 1 1 2 2
corr s near 2
