#########
#4 5 G 6#
# # ### #
#7#3 8# #
### #####
#  1#2  #
### # # #
#0 9 P# #
#########
opt 3 3 0 0 0 0 0 0 2 2
hint near 5
bad 0 0
corr e near 2
