#########
#5 P   7#
# #######
#  3 G 8#
##### ###
#0 1 9  #
### # ###
#  6#2 4#
#########
opt 2 2 1 1 3 3 3 3
hint near 3
bad 3 3 3 3
corr w near 3
