#############
#G  # #     #
# # # # #####
# #1 6   P  #
# # ### #####
#5#7#2  #4  #
##### ### # #
#        0# #
# ### ##### #
# # #   #8  #
# # ### #####
#   #  9 3  #
#############
opt 3 3 3 3 3 3 0 0 3 3
hint near 1
bad 3 3 3 3 0 0
corr e near 6
