#########
#8 2#1#P#
### # # #
#9 3 5 0#
# ##### #
#6 G#   #
# # ### #
# #4  #7#
#########
opt 1 1 3 3 3 3 3 3 1 1 2 2
hint near 3
bad 1 1 1 1
corr e near 0
