#########
#3#  5#8#
# ### # #
#2   0 4#
# # # ###
#1#9# #7#
### ### #
#P 6 G  #
#########
opt 2 2 2 2
hint near 6
bad 2 2 0 0 0 0 2 2
corr w near 6
