#########
#3  #9 5#
### ### #
#  4#G 8#
# ##### #
#0#1 6#2#
# # ### #
#7 P    #
#########
opt 2 2 2 2 0 0 0 0 3 3
hint near 4
bad 3 3 0 0 0 0 2 2 0 0
corr w near 1
