#########
#  5 6 3#
##### ###
#  2 P 1#
# # # ###
# # #4 9#
# ##### #
#0#G 7 8#
#########
opt 1 1 3 3 1 1 2 2 2 2
hint near 0
bad 2 2
corr s near 1
