#########
#4#2 6  #
# # #####
#9#G#3 1#
# # # ###
#7#  0 8#
# # ### #
#P    #5#
#########
opt 3 3 0 0 0 0
hint near 2
bad 0 0 0 0
corr e near 7
