#########
#4#P#0  #
# # # # #
#7   1#8#
# #######
#    2#G#
# ##### #
#6 3 9 5#
#########
opt 1 1 3 3 1 1 1 1 2 2 2 2 2 2 0 0
hint near 2
bad 1 1 2 2 0 0 2 2
corr e near 1
