#############
#   #   #P 1#
### # ##### #
#  6  #0    #
# ### # ### #
#   # # # # #
# ##### # ###
# # #7# #3 4#
# # # # ### #
#      8    #
##### # #####
#G 2  #9   5#
#############
opt 2 2 1 1 3 3 3 3 1 1 1 1 1 1 3 3 1 1 3 3 3 3
hint near 2
bad 2 2 1 1 3 3 3 3 1 1 1 1 1 1 3 3 3 3 3 3
corr s near 7
