#########
#7#6 5#1#
# # ### #
#8#0    #
# # # ###
#  2#4  #
# ##### #
#9#G 3 P#
#########
opt 2 2 2 2
hint near 2
bad 0 0 2 2
corr w near 3
