#########
#P#  4#8#
# # ### #
#3 9 7 G#
##### ###
# #0# #5#
# # # # #
#2 6 1  #
#########
opt 1 1 3 3 3 3 3 3
hint near 5
bad 1 1 3 3 0 0 3 3
corr e near 9
