#########
#7 1#2# #
# # # # #
#4#5 P  #
##### ###
# #G 0 9#
# ##### #
#6   3 8#
#########
opt 1 1 3 3
hint near 0
bad 1 1 2 2 1 1 3 3 3 3 3 3
corr e near 0
