#############
#9    # # #P#
# ##### # # #
#7  #  5#3# #
# # ### # # #
# #2    # #0#
### ##### # #
#1  # #G    #
### # ### ###
#  6   8  #4#
# ##### ### #
#   #       #
#############
opt 1 1 1 1 1 1 3 3 3 3
hint near 8
bad 1 1 1 1 1 1 3 3 1 1 3 3 3 3 3 3 0 0 0 0 2 2 2 2 0 0
corr e near 0
