#########
#9  #2#6#
### # # #
#4 8# #7#
### # # #
#G 3#0 5#
### # # #
#  1 P# #
#########
opt 3 3 0 0 3 3
hint near 3
bad 3 3 3 3
corr n near 1
