#########
#7#P#0 G#
# # ### #
#2   1#5#
# # # # #
#8# #  3#
# ### ###
#9#4 6  #
#########
opt 1 1 2 2 1 1 2 2 0 0 0 0
hint near 0
bad 1 1 2 2
corr keep going
