#############
#  1#0  #4  #
# ### ### # #
#3   7  # # #
##### ### ###
#8   5  #  9#
# ######### #
# #   #6#  P#
# # ### # # #
#       # # #
### ### ### #
#  2 G#     #
#############
opt 1 1 1 1 3 3 3 3 0 0 3 3 3 3 1 1 2 2
hint near 2
bad 1 1 1 1 3 3 3 3
corr keep going
