#########
#4 0 8#G#
### # # #
#2#P#9 5#
# # #####
#      6#
# ### # #
#3#7 1# #
#########
opt 0 0 2 2 1 1 2 2 0 0
hint near 5
bad 0 0 2 2
corr keep going
