#########
#5#4  #2#
# # ### #
#   #G 6#
# ### ###
#  8#9#7#
# ### # #
#3 P 1 0#
#########
opt 3 3 0 0 0 0
hint near 6
bad 2 2 0 0 0 0 3 3 0 0 3 3
corr e near 1
