#############
# #  4   5  #
# ####### ###
#  7#  G#  9#
# ### # ### #
#3 1# # #8  #
### # ##### #
#  6      # #
####### ### #
#           #
### # #######
#   #2   P 0#
#############
opt 3 3 3 3 0 0 2 2 0 0 3 3 0 0 0 0 2 2
hint near 4
bad 3 3 3 3 0 0 2 2 2 2 2 2 0 0 0 0 0 0 3 3 0 0 3 3 3 3
corr n near 2
