#########
#  0 P 5#
### # ###
#3 9#   #
# # ### #
#4#2 6#7#
# ### ###
#  1#G 8#
#########
opt 2 2 1 1 1 1 3 3 1 1
hint near 1
bad 1 1 3 3 1 1
corr w near 0
