#########
#5   P 8#
# ##### #
#3 6  #G#
### #####
#0   7 9#
# ### # #
#2#4 1# #
#########
opt 2 2 1 1
hint near 8
bad 3 3 3 3 1 1 2 2
corr w near 8
