#############
#    G#   #2#
##### ### # #
#9  #P# #1# #
# # # # # # #
# #      4  #
# # ##### # #
# #6# #7  #8#
# ### ### # #
#     #  0#3#
# ### # ### #
# #   #   #5#
#############
opt 0 0
hint near 1
bad 1 1 3 3 0 0
corr n near 1
