#############
#   #  5    #
# # ### # # #
#2#  7  #0# #
# ### # ### #
#   # #8#3# #
# # # # # # #
# #6# #G  #P#
### # ### ###
#  1#   #4 9#
# ##### # ###
#   #   #   #
#############
opt 0 0 0 0 0 0 3 3 3 3 1 1 1 1 1 1
hint near 8
bad 0 0 0 0 0 0 3 3 3 3 1 1 3 3 1 1 1 1 1 1
corr s near 0
