#############
#2 1 0  #3  #
# # ##### ###
# #  4 P#   #
# ### ### # #
# # #     # #
### # ### ###
#9#  8  #5  #
# # #########
#           #
### ##### ###
#G 6#      7#
#############
opt 3 3 1 1 1 1 3 3 1 1 1 1 3 3
hint near 6
bad 3 3 1 1 1 1 3 3 1 1 2 2 2 2 2 2 1 1 3 3 3 3
corr s near 6
