#############
#    6#  P  #
# # ### # # #
# #2   8# # #
# ### ### ###
# #G#  4#9  #
### ##### ###
#7   3      #
# # ### #####
# # #  5 0  #
# # # ### # #
# # #   #1# #
#############
opt 1 1 1 1 1 1 3 3 3 3 3 3 0 0
hint near 2
bad 3 3 1 1 3 3 3 3 0 0 3 3 1 1 1 1
corr s near 6
