#########
#8#1 G 9#
# ##### #
#P     5#
# #######
#4 7   2#
### # ###
#  0#6 3#
#########
opt 3 3 3 3 3 3 0 0 2 2
hint near 1
bad 3 3 3 3
corr keep going
