#########
#8   5#1#
### ### #
#2 3 G 0#
### #####
#6     4#
# # #####
#7#P   9#
#########
opt 0 0 0 0 3 3
hint near 0
bad 3 3
corr n near 7
