#########
#2#P#0# #
# # # # #
#9   8 6#
# # # ###
# # #7 4#
# # # ###
#G#5#1 3#
#########
opt 1 1 2 2 1 1 1 1
hint near 5
bad 1 1 1 1 1 1
corr w near 8
