#########
# #G  #7#
# ### # #
#0#6 1 P#
# # #####
#4     3#
### ### #
#2 9 8#5#
#########
opt 3 3 0 0 3 3
hint near 6
bad 3 3 3 3 1 1 3 3 0 0
corr n near 1
