#########
#3 P 5#8#
# # # # #
#4# #0  #
# ### ###
#G 6#7# #
##### # #
#1   2 9#
#########
opt 3 3 1 1 1 1
hint near 1
bad 2 2 1 1 1 1 1 1 3 3 3 3
corr e near 3
