#########
#  G#3 8#
### ### #
#9# #6 7#
# # ### #
#  4 2 0#
# #######
#P 1 5  #
#########
opt 0 0 2 2 0 0 0 0
hint near 3
bad 0 0 2 2 2 2 2 2 0 0 3 3
corr n near 4
