#############
#  4    # #P#
# # ### # # #
# # #3# #   #
### # # # ###
#0  #1# #  5#
##### # ### #
#7  #   #9#2#
# # # ### # #
# #         #
# ##### # ###
#6  #  8#G  #
#############
opt 1 1 3 3 1 1 2 2 1 1 1 1 3 3 1 1
hint near 8
bad 1 1 3 3 1 1 2 2 1 1 1 1 3 3 3 3 1 1
corr s near 9
