#########
#G#5 9 3#
# ### ###
#  7   P#
# ### ###
#1#0   4#
### #####
#8 2 6  #
#########
opt 3 3 3 3 3 3 0 0
hint near 5
bad 3 3 0 0
corr e near 7
