#########
#  9#2 G#
### ### #
#  5 0 3#
# ### ###
#P#6#  1#
### # # #
#8 4  #7#
#########
opt 0 0 3 3 3 3 3 3 0 0
hint near 2
bad 0 0 3 3 3 3 1 1 3 3
corr e near 0
