#########
#  3#6 2#
### # ###
#4   8 9#
####### #
#  5 G#0#
# ##### #
#P 7 1  #
#########
opt 0 0 2 2 2 2
hint near 0
bad 2 2 2 2 2 2 0 0 0 0 3 3 0 0
corr n near 7
