#############
# #6      # #
# # ####### #
# #5  #1 3  #
# # # # #####
#0# #P   9# #
# # ### ### #
#2  #       #
######### # #
#  7  #4  # #
# ##### # ###
#8      #G  #
#############
opt 2 2 1 1 2 2 1 1 1 1
hint near 4
bad 2 2 1 1 2 2 1 1 3 3 1 1
corr s near 4
