#############
#0        #4#
##### # ### #
# #  3# #  5#
# # ### # # #
#  6  #9  # #
####### #####
#2      #   #
# ##### # # #
#8#      G# #
# # ##### ###
# #P 7  #1  #
#############
opt 0 0 2 2 2 2 2 2
hint near 1
bad 2 2 2 2
corr n near 7
