#########
#  1 P 4#
# # ### #
#8#  6# #
### ### #
#3# #G 2#
# ##### #
#9 0 5 7#
#########
opt 3 3 1 1 1 1 2 2
hint near 2
bad 2 2 1 1 3 3
corr e near 1
