#########
#0 G 5 7#
##### # #
#  P 8#9#
##### ###
#  6   3#
### # ###
#  2#1 4#
#########
opt 3 3 0 0 2 2
hint near 0
bad 3 3 1 1 2 2
corr n near 8
