#########
#  4 1 3#
# # ### #
#5#8#  P#
##### ###
#2   6  #
# ### ###
#7 G#9 0#
#########
opt 3 3 1 1 3 3 3 3 1 1 2 2
hint near 7
bad 3 3 1 1 1 1
corr e near 6
