#########
#4 5 1 2#
# # #####
#9#6   G#
# # ### #
# #8 3# #
##### ###
#0 P   7#
#########
opt 3 3 0 0 2 2 0 0 3 3 3 3
hint near 2
bad 3 3 0 0 2 2 0 0 0 0 3 3
corr e near 6
