#############
#0 9    #7 2#
# ##### # ###
# #  4      #
# ##### ### #
#   #    1#5#
# # # # #####
#3# #G#     #
# ####### ###
#P  #    6  #
# # ### #####
# # #  8    #
#############
opt 0 0 0 0 0 0 0 0 2 2 2 2 2 2 1 1 1 1 3 3 1 1
hint near 3
bad 0 0 0 0 0 0 0 0 2 2 2 2 2 2 1 1 3 3
corr s near 4
