#########
#3#6# #7#
# # # # #
#2 4 0  #
# #######
#8 9 1  #
# ##### #
#  P#G 5#
#########
opt 3 3 0 0 2 2 2 2 2 2 1 1 3 3
hint near 1
bad 3 3 0 0 0 0 2 2 2 2
corr w near 8
