#########
#9 3   6#
### #####
#1   4 7#
# #######
#5 P#G 8#
# ### ###
#0     2#
#########
opt 3 3 1 1 2 2 2 2 0 0
hint near 4
bad 3 3 0 0 2 2 0 0 2 2
corr s near 5
