#########
#5#2 G#1#
# ### # #
#7   0 6#
### # # #
#8 9#3#P#
### #####
#    4  #
#########
opt 0 0 2 2 0 0
hint near 0
bad 0 0 0 0
corr w near 6
