#########
#  9#3 2#
### ### #
#6 P 1  #
####### #
#G   0#4#
# # # # #
#8#5#7  #
#########
opt 3 3 3 3 1 1 1 1 2 2 0 0 2 2 2 2
hint near 6
bad 2 2
corr e near 1
