###########
#     # # #
### ### # #
#   #   # #
# ### ### #
#         #
# ##### ###
# # #   # #
# # ##### #
#P   G    #
###########
2 2 2 2
