#########
#2   G#4#
# ##### #
#8#1    #
# ### # #
#P#9# #7#
# # ### #
#0 6 3 5#
#########
opt 0 0 0 0 2 2 2 2
hint near 4
bad 1 1 2 2 2 2 2 2 0 0 0 0
corr n near 0
