#########
#8# #9 5#
# # # ###
#3 6  #0#
##### # #
#1 4 P G#
# # #####
# #2 7  #
#########
opt 3 3
hint near 0
bad 2 2 1 1 3 3
corr e near 4
