#########
#4 8#G  #
### ### #
#P#1 3 9#
# # ### #
#6   0#2#
# # # # #
# #7#5# #
#########
opt 1 1 3 3 0 0 3 3 3 3 0 0 2 2
hint near 3
bad 1 1 3 3 0 0 3 3
corr keep going
