#############
#9   3#1  # #
### # ### # #
# # #6  #2  #
# ### ##### #
#P     7   0#
# ##### ### #
#   #  8 G# #
##### ##### #
#    4  #   #
### # # # # #
#   #5# # # #
#############
opt 2 2 2 2 2 2 1 1 2 2
hint near 8
bad 2 2 2 2 2 2 2 2 2 2 0 0 3 3
corr s near 7
