#############
#  4  #G 0# #
### # # ### #
#3 6# #     #
# ####### # #
#P    #8  #2#
# # ### ### #
#7#   # # # #
# ### # # ###
#5#  9    # #
# ### ##### #
#1  #       #
#############
opt 2 2 1 1 2 2 1 1 2 2 0 0 0 0 2 2 0 0 3 3 0 0
hint near 0
bad 0 0 2 2 0 0 2 2 1 1
corr w near 3
