#############
#     # #   #
# ##### # ###
#  4 P#7 1  #
### ### # ###
#6     G# # #
# ### ##### #
# #3       5#
# ### #######
# #2  #0    #
# ### # # # #
# #  9  #8# #
#############
opt 3 3 1 1 2 2 2 2
hint near 7
bad 3 3 1 1 2 2 1 1 1 1 1 1 2 2 0 0
corr w near 3
