#########
# # #2#5#
# # # # #
#  1 7  #
# ### # #
#3#8 6#0#
### ### #
#9 4#G P#
#########
opt 2 2
hint near 4
bad 0 0 0 0 2 2 1 1 2 2
corr w near 0
