#########
#2  #6 4#
### # ###
# #9 1  #
# # # ###
#G P#8 7#
# # # # #
# #0#5#3#
#########
opt 3 3
hint near 0
bad 0 0 2 2 1 1
corr e near 0
