#########
#  6#P#G#
# ### # #
#9 7 4 1#
##### # #
#  8  #0#
# ##### #
#2#3 5  #
#########
opt 1 1 3 3 0 0
hint near 1
bad 1 1 2 2 2 2 0 0 3 3
corr e near 4
