#########
#8#    G#
# ### ###
#P 3#  1#
### # ###
#5 6 2 9#
### #####
#  7 4 0#
#########
opt 2 2 1 1 2 2 0 0 0 0 2 2
hint near 1
bad 2 2 1 1 2 2 0 0 2 2
corr n near 1
