#########
#8   G 6#
### ### #
#2 0# #9#
### # ###
#  7#3#4#
### # # #
#1   P 5#
#########
opt 3 3 0 0 0 0 0 0 2 2
hint near 6
bad 0 0 0 0
corr e near 3
