#########
#  6 1# #
# ##### #
#3 9#4# #
# ### # #
#5#0 8 7#
# # # ###
#G  #2 P#
#########
opt 2 2 0 0 2 2 1 1 2 2
hint near 5
bad 2 2
corr keep going
