#########
#8 2 G 5#
##### ###
#  6   0#
# # #####
#4#7  #1#
### # # #
#P  #9 3#
#########
opt 3 3 0 0 0 0 3 3 0 0
hint near 2
bad 3 3 0 0 3 3
corr n near 7
