#############
#6  # # #2#P#
### # # # # #
#    G#1  #9#
### # ### # #
#3  #   #   #
# ### # # # #
#5#7  #   # #
### # ##### #
#0  # #   #4#
# ####### # #
#         #8#
#############
opt 1 1 1 1 3 3 1 1 3 3 0 0 3 3 0 0
hint near 1
bad 1 1 1 1 3 3 0 0
corr s near 1
