#########
# #2#8 7#
# # ### #
#P 5   1#
### # ###
#9#G#4 3#
# # # ###
#0  #  6#
#########
opt 2 2 1 1
hint near 4
bad 2 2 2 2 1 1
corr s near 5
