#############
#2#6# #     #
# # # ##### #
#8#5#   #   #
# # # ### # #
# #P    # # #
# ### ### # #
# #  3 G  # #
# ### # #####
# #   #  1 7#
# ### ##### #
#  0 9 4  # #
#############
opt 2 2 1 1 2 2
hint near 3
bad 2 2 2 2
corr s near 3
