#########
#5# #G 3#
# # ### #
#0 4   9#
# #######
#  P#6 7#
# ##### #
#  8 1 2#
#########
opt 3 3 0 0 2 2 2 2 2 2 0 0 3 3
hint near 3
bad 3 3 0 0 2 2 0 0
corr w near 4
