#############
#  7      # #
##### ##### #
#  3    #   #
### ### ### #
#1#6# # # # #
# ### # # # #
#2 8 5#P    #
##### ### # #
#9#G#     # #
# # # # # # #
#4    #0# # #
#############
opt 2 2 1 1 3 3 3 3 1 1 3 3 0 0
hint near 8
bad 2 2 1 1 3 3 3 3 0 0 3 3
corr s near 5
