#############
#   #3#0# # #
# # # # # # #
# #  8# #   #
### # # # # #
#1  # #   # #
##### # # ###
#6    #4#9 G#
# ##### # # #
#2   P# #5# #
# ##### # # #
#      7# # #
#############
opt 3 3 3 3 1 1 2 2 2 2 2 2 0 0 0 0 0 0 2 2 1 1 2 2
hint near 9
bad 3 3 3 3 1 1 2 2 2 2 2 2 0 0 0 0 0 0 2 2 0 0 2 2
corr s near 9
