#############
# # #0 8    #
# # ### ### #
#2  #5#   # #
### # ### ###
#3#   #     #
# ### # ### #
#  G P#4 9#7#
##### # # # #
#       # #6#
# ####### ###
#   #1      #
#############
opt 3 3
hint near 3
bad 1 1 2 2 0 0
corr e near 4
