#########
#0 1 9# #
# ### # #
# #6 3 P#
# ### # #
#G#5 2# #
# # ### #
#7#4#  8#
#########
opt 2 2 0 0 2 2 2 2 1 1 1 1
hint near 5
bad 2 2 1 1 2 2
corr n near 3
