#############
#2# #5  #P 7#
# # # ### ###
#G  #       #
# ##### #####
#  6  #     #
# # ### # ###
# #4#1# #3  #
### # # #####
#0   9  #  8#
### ##### ###
#           #
#############
opt 1 1 3 3 1 1 1 1 1 1 3 3 3 3 0 0 0 0 3 3 0 0
hint near 2
bad 1 1 3 3 3 3
corr s near 5
