###########
#   #  P# #
### ### # #
#         #
####### ###
#   #G# # #
# # # # # #
# #   #   #
# # # ### #
# # #     #
###########
1 1 1 1 1 1 2 2 1 1 3 3 3 3 0 0 0 0
