#############
#    P  #   #
# # ####### #
# #  0#2    #
### ### # ###
#6 8    #   #
####### ### #
#    4# # # #
# ####### # #
#9 1 5#    7#
### # # ### #
#   #3 G  # #
#############
opt 3 3 1 1 1 1 2 2 2 2 0 0 2 2 1 1 2 2 1 1 1 1 3 3 3 3 1 1
hint near 3
bad 3 3 1 1 1 1 2 2 2 2 0 0 2 2 1 1 2 2 1 1 1 1 1 1
corr e near 7
