#########
#  7   P#
# ### # #
#4 G#5#2#
##### ###
#8 9 6#1#
### ### #
#3     0#
#########
opt 3 3 3 3 3 3 1 1 2 2
hint near 4
bad 3 3 1 1
corr e near 5
