#########
#2#8   6#
# ### ###
#G   3 1#
### #####
#9 7   0#
### #####
#  5 4 P#
#########
opt 2 2 2 2 0 0 0 0 2 2
hint near 2
bad 2 2 2 2 2 2
corr n near 5
