#########
#2  #6#1#
### # # #
#  4#  G#
# ##### #
#5#3 8#0#
# ### # #
#7 9 P  #
#########
opt 2 2 0 0 0 0
hint near 0
bad 0 0
corr w near 8
