#########
#8   2#G#
##### # #
#  0#6 P#
### # ###
#5 1 4 7#
# # ### #
#9# #  3#
#########
opt 0 0
hint near 2
bad 3 3 1 1 2 2
corr n near 6
