#########
#G  #3  #
# ### ###
#4 1 P 2#
### # # #
#  7#5#8#
# ### # #
# #0 9#6#
#########
opt 2 2 2 2 0 0
hint near 4
bad 2 2 1 1 2 2
corr w near 1
