#########
#7 3  #P#
##### # #
#G#  4  #
# ### # #
#6#5 2#0#
# # #####
#1 9   8#
#########
opt 1 1 2 2 1 1 2 2 1 1 2 2 0 0 0 0
hint near 6
bad 1 1 2 2 0 0 2 2 2 2
corr s near 4
