#########
#  8#  2#
### # ###
#9#P   G#
# ### ###
#  7 3 4#
# # # ###
#1#6#5 0#
#########
opt 3 3 3 3
hint near 2
bad 3 3 0 0 3 3
corr e near 3
