#########
#  9 P#5#
##### # #
#7   1  #
# ##### #
#3 0#6 4#
# # # ###
#8# #G 2#
#########
opt 1 1 3 3 1 1 2 2 1 1
hint near 2
bad 1 1
corr keep going
