#########
#9   7 8#
# ### # #
#4 3# # #
# ### # #
#1  #P#6#
# # # # #
#0#5#G#2#
#########
opt 1 1
hint near 2
bad 0 0 0 0 3 3 1 1 1 1
corr s near 6
