#############
#   # #     #
### # ### # #
#  0#   # # #
# ##### # ###
#  4 G#     #
# ######### #
#9#     #3 P#
# # ##### # #
#6#  8    #5#
# # ####### #
#1 2 7    # #
#############
opt 3 3 1 1 3 3 3 3 3 3 1 1 3 3 0 0 0 0 0 0 2 2 2 2
hint near 4
bad 3 3 1 1 3 3 3 3 3 3 0 0 2 2 2 2
corr s near 2
