#############
#2#   #  0 1#
# # # # ### #
# # #9 8  # #
# ####### ###
#   #6 5 P  #
### ##### ###
# # # #   # #
# # # ### # #
#4#  G#     #
# # ### #####
#    7 3    #
#############
opt 1 1 1 1 3 3 1 1 3 3 3 3 0 0 2 2
hint near 7
bad 1 1 1 1 3 3
corr keep going
