#########
#    0#8#
### ### #
#5 6  #1#
##### # #
#4 7 P  #
# ### # #
#3 9#G#2#
#########
opt 1 1
hint near 2
bad 2 2 2 2 1 1 3 3
corr s near 7
