#########
#2 1#8 4#
### # ###
#6 P  # #
### # # #
#  9#0  #
# #######
#5 3 G 7#
#########
opt 1 1 2 2 1 1 3 3 3 3
hint near 0
bad 3 3 1 1 3 3
corr s near 1
