#########
#9 7    #
### # ###
#1 8#P 6#
# ##### #
# #3#2  #
# # # # #
#5 4#G#0#
#########
opt 3 3 1 1 2 2 1 1
hint near 0
bad 0 0 2 2 1 1 2 2 1 1 1 1 3 3
corr e near 2
