#########
#5#0 1#7#
# ### # #
# #2#6 G#
# # # # #
#  3 4#9#
### # ###
#  8#P  #
#########
opt 0 0 0 0 2 2
hint near 6
bad 0 0 3 3 0 0
corr n near 4
