#########
#1 P 8 5#
# # ### #
#4#G#2 7#
### #####
#0   6#9#
# # # # #
# # #3  #
#########
opt 1 1
hint near 2
bad 2 2 2 2 1 1 3 3
corr s near 1
