#########
#  1   0#
# #######
#  5 8 3#
# # #####
#7#4#  2#
### # # #
#P 6 9#G#
#########
opt 3 3 3 3 0 0 3 3 1 1
hint near 2
bad 3 3 3 3
corr keep going
