#############
#   # #6#7#1#
### # # # # #
#    3    #4#
### ### # # #
#5 2#   #   #
##### # #####
# #   #9    #
# ##### # # #
#P      # # #
### ####### #
#  0    #G 8#
#############
opt 2 2 2 2 2 2 0 0 2 2 2 2 1 1 1 1 3 3
hint near 8
bad 2 2 2 2 2 2 0 0 2 2
corr keep going
