#########
#  3#2 0#
### # # #
#9 5 8#6#
### # ###
#7#P#  G#
# # # ###
#  4#  1#
#########
opt 0 0 3 3 1 1 3 3
hint near 1
bad 0 0 3 3 1 1 1 1 3 3
corr e near 8
