#############
#7#6    #   #
# # # ### # #
#3  #4#G  #8#
# ##### ### #
#     #   # #
# # ##### # #
#5#P# # # # #
### # # # ###
# #        1#
# # ### # ###
#2 0  # #  9#
#############
opt 1 1 2 2 2 2 2 2 0 0 0 0 3 3 0 0
hint near 4
bad 0 0 3 3 0 0 2 2
corr s near 5
