#########
#    1  #
### #####
#3 4 0 G#
### # # #
#8 2#6# #
# ### ###
#5#P 9 7#
#########
opt 3 3 0 0 0 0 3 3
hint near 0
bad 3 3 0 0 0 0 2 2 0 0 3 3 3 3
corr e near 0
