#########
#0 3#6 2#
### # ###
#P#5 8#G#
# # ### #
#9# #1#7#
# # # # #
#  4    #
#########
opt 1 1 1 1 3 3 3 3 3 3 0 0 0 0
hint near 2
bad 1 1 1 1 3 3 0 0 0 0 3 3
corr e near 4
