#########
#    9 7#
### # # #
#3#G#4#6#
# ### # #
#8   0#5#
# ##### #
# #2 P 1#
#########
opt 3 3 0 0 0 0 0 0 2 2 2 2 1 1
hint near 3
bad 2 2
corr e near 0
