#########
# #6 4  #
# # ### #
#1 7#P 0#
### # # #
#8#9#G# #
# ### # #
#3 5 2# #
#########
opt 1 1
hint near 2
bad 2 2 0 0 3 3 3 3 1 1
corr s near 0
