#############
#    P  # #0#
# # # ### # #
# # #2 8 4  #
# ####### # #
#    3#6  # #
### # # # # #
#  G# # # # #
### ##### ###
# #5 1#9    #
# # # # # ###
#7  # # #   #
#############
opt 3 3 3 3 1 1 1 1 2 2 1 1
hint near 5
bad 3 3 1 1
corr e near 2
