#############
#       #7  #
# ### # # ###
# #9# #  6#0#
# # ##### # #
#4#     #8  #
# ### #######
#1 P        #
####### # # #
# #    2# # #
# # ### ### #
#     #G#5 3#
#############
opt 2 2 2 2 1 1 1 1
hint near 2
bad 2 2 2 2 2 2 1 1
corr s near 2
