#########
#2 7#0  #
# # ### #
#9# # #5#
### # # #
#3 8 6 4#
# #######
#P   G 1#
#########
opt 3 3 3 3
hint near 1
bad 0 0 3 3 3 3
corr e near 3
