#############
#   #1  #   #
# ### # # ###
#    G#  8  #
### ### # # #
#4  #5  # # #
# ###########
#7 0  #     #
# ### # # ###
#   #3  #6 9#
# # # #######
#2# #  P    #
#############
opt 3 3 0 0 0 0 3 3 3 3 0 0 2 2 0 0 2 2
hint near 1
bad 3 3 0 0 0 0
corr keep going
