#########
#1 9 3 G#
### #####
#6 4 2  #
### ### #
#8 7  #P#
# # #####
#5#0    #
#########
opt 0 0 2 2 2 2 0 0 3 3 3 3
hint near 3
bad 0 0 2 2
corr keep going
