#############
#   #     # #
### # ##### #
#4     5#  7#
# ### # ### #
#9  #G# #   #
# ####### # #
#   #  8#0# #
# # # ##### #
# #3       1#
# # ### # ###
#P#  2# #  6#
#############
opt 0 0 0 0 0 0 0 0 2 2 2 2 1 1
hint near 5
bad 0 0 0 0 2 2
corr n near 9
