#############
#P 6#   #   #
### ### # # #
#2  #     #0#
# # ### ### #
#1# #    4# #
### # #######
#           #
# ### ### # #
#3 5#G  # #7#
# ####### ###
#9   8  #   #
#############
opt 2 2 1 1 1 1 1 1 2 2 1 1
hint near 5
bad 2 2 1 1 1 1 1 1 3 3 1 1 1 1 2 2 2 2 2 2
corr w near 5
