#########
#7#    0#
# # ### #
#2 3#4 G#
##### ###
#5#6   8#
# # # # #
#9 1#P# #
#########
opt 0 0 0 0 3 3
hint near 0
bad 0 0 3 3
corr n near 4
