#########
#    3 P#
# # #####
# #G#7 1#
# ### # #
#0#4 2#8#
# # # ###
#9 6#5  #
#########
opt 3 3 3 3 1 1
hint near 4
bad 3 3 3 3 3 3 1 1
corr s near 3
