#############
#   #  0 9  #
# # # # ### #
# # # # #   #
# # # ##### #
# # # # #5 G#
### # # # # #
#  1 7#  4# #
##### # # # #
#  6 2# # #8#
# ##### # ###
#     #P#  3#
#############
opt 0 0 0 0 2 2 0 0 2 2
hint near 5
bad 0 0 0 0 0 0
corr w near 4
