#############
#   #P#  2  #
### # ##### #
# #       # #
# # ### ### #
# #4#9#0 7  #
# # # # # ###
#   #8  #   #
##### # ### #
#  3 1# #   #
### ### ### #
#6  #G 5  # #
#############
opt 1 1 2 2 1 1 1 1 1 1 1 1 3 3
hint near 1
bad 1 1 2 2 1 1 1 1 3 3 1 1 3 3
corr s near 0
