#########
#1 9 G 4#
##### ###
#  8 0 5#
# ##### #
#P#6#2#3#
# # # # #
#    7# #
#########
opt 0 0 3 3 3 3 0 0
hint near 0
bad 1 1 3 3 3 3 0 0
corr n near 6
