#########
#5 7# # #
### # # #
#1#G 8  #
# ##### #
#3 6#0 P#
### # # #
#2 4 9# #
#########
opt 0 0 2 2 2 2
hint near 1
bad 2 2 1 1 2 2 0 0 2 2
corr n near 0
