###########
#       # #
####### # #
# #     # #
# ##### # #
#    P  #G#
####### # #
# #   #   #
# # ### ###
#         #
###########
2 2 1 1 2 2 0 0
