#########
#G# #7  #
# # ### #
#0 1 2# #
### ### #
#  4 5#8#
# # # # #
#6#9#3 P#
#########
opt 2 2 0 0 2 2 0 0 2 2 0 0
hint near 0
bad 0 0 0 0 0 0 2 2
corr w near 3
