#############
#3      #1  #
# ### ##### #
# #2  #   #6#
# # # # ### #
#7# #       #
### ### ### #
# #9#     #5#
# # # ### ###
#  4# #8#  G#
##### # # ###
#P   0  #   #
#############
opt 2 2 2 2 0 0 0 0 2 2 2 2 1 1 2 2
hint near 5
bad 2 2 2 2 0 0 0 0 2 2 2 2 1 1 1 1 2 2
corr w near 8
