#########
#3#7   G#
# # #####
#   #0 1#
# # # ###
#5#6 2  #
##### # #
#9 8 4#P#
#########
opt 0 0 2 2 2 2 0 0 0 0 3 3 3 3
hint near 1
bad 0 0
corr keep going
