#########
#0 4   2#
### # ###
#6  #G#7#
##### # #
#8#1 P  #
# ### ###
#  5 9 3#
#########
opt 0 0
hint near 7
bad 2 2 0 0
corr n near 1
