#########
#5#2# # #
# # # # #
#4 6 P#G#
### # # #
#  3#  7#
##### ###
#9 1 0 8#
#########
opt 1 1 2 2 0 0
hint near 7
bad 1 1 1 1 2 2
corr w near 0
