#########
#4#  1# #
# # # # #
#0 5#8#2#
# ##### #
#P 3 G 9#
# # #####
#7#  6  #
#########
opt 3 3 3 3
hint near 3
bad 3 3 1 1 3 3
corr e near 3
