#########
#  1 2# #
# ### # #
#8#6 7 P#
### ### #
#5#3 4# #
# ### ###
#G   0 9#
#########
opt 2 2 2 2 1 1 3 3 1 1 2 2 2 2
hint near 5
bad 2 2 0 0 2 2 2 2 1 1
corr w near 7
