#############
#3   7#   # #
# # # ### # #
#0# #       #
# ####### ###
# #    5    #
### # # ### #
#2  # #P G#4#
# ### ##### #
# # #1   9# #
# # # ### ###
# #  6#  8  #
#############
opt 2 2
hint near 4
bad 0 0 3 3 1 1 1 1 2 2 2 2
corr w near 5
