#########
# #  3 0#
# ##### #
#G 8 9 P#
### ### #
#7 6#4 2#
### # # #
#1 5# # #
#########
opt 2 2 2 2 2 2
hint near 7
bad 0 0 2 2 2 2
corr w near 0
