#########
# # #G  #
# # # ###
#2#7 P#9#
# ### # #
#0 1 3 8#
# # # # #
#6# #4#5#
#########
opt 0 0
hint near 3
bad 1 1 3 3 3 3 0 0 0 0
corr n near 3
