#############
#2     3    #
# # #########
# #   #    9#
### # # #####
#   #     #7#
### ####### #
#4#5 G# #1 P#
# ### # # ###
#         # #
# # # ##### #
# #6#8     0#
#############
opt 3 3 1 1 3 3 3 3 0 0
hint near 5
bad 3 3 1 1 3 3 0 0
corr e near 1
