#########
#3#1#9 8#
# # # ###
#2  #  5#
# ### ###
#6 P#  G#
# # # ###
#4#0   7#
#########
opt 1 1 3 3 0 0 3 3
hint near 5
bad 1 1 3 3 0 0 0 0 0 0 3 3
corr e near 0
