#########
#3 4  # #
# ### # #
#1#2 P  #
####### #
#9 G 6 7#
### # ###
#  8#5 0#
#########
opt 2 2 1 1 3 3 3 3
hint near 2
bad 3 3
corr w near 2
