#############
# #2# #  4  #
# # # # #####
# #P  #0  # #
# # ### ### #
#5         9#
# # ####### #
# #  1# #  7#
####### # # #
#G 8      # #
##### ### ###
#6 3  #     #
#############
opt 1 1 2 2 2 2 2 2 2 2 1 1 3 3 1 1 3 3 3 3 3 3 3 3
hint near 6
bad 1 1 2 2 2 2 2 2 2 2 1 1 3 3 1 1 3 3 3 3 1 1 3 3 3 3
corr e near 1
