#########
#G  #4 7#
### ### #
# #6 1#0#
# ### # #
#5 9  # #
### # # #
#P 3#8 2#
#########
opt 2 2 0 0 2 2 0 0 3 3 0 0 3 3
hint near 4
bad 2 2 0 0 3 3 0 0
corr w near 9
