#########
#G#8   2#
# ### # #
#3   1#9#
##### ###
#5   4 6#
# ### ###
#P#  7 0#
#########
opt 0 0 3 3 3 3 0 0 2 2 2 2 0 0
hint near 3
bad 0 0
corr keep going
