#########
#9 5 G 8#
##### ###
#3 1 P  #
### ### #
#    0# #
### # ###
#6 2#4 7#
#########
opt 0 0
hint near 5
bad 2 2 1 1 3 3
corr n near 0
