#########
#7#    5#
# # #####
#0 9 4 G#
### #####
# #6 1 2#
# # ### #
#P   3#8#
#########
opt 2 2 0 0 0 0 2 2 2 2
hint near 2
bad 2 2 0 0 2 2 2 2
corr n near 6
