#############
#   # # #   #
### # # ### #
#  8    #   #
# ### ### ###
#6  #1#0    #
# ##### #####
#  P       2#
##### ##### #
#   #  5 G# #
### # # ### #
#4 9 7#  3# #
#############
opt 2 2 1 1 2 2 2 2
hint near 3
bad 2 2 2 2 2 2 2 2 1 1
corr s near 1
