#############
#    P#1#6# #
##### # # # #
#    0# #5  #
### ### # # #
#     #G  # #
# ### ##### #
#2#4      #7#
# # ##### # #
# # #3  # # #
### # # # # #
#  8 9# #   #
#############
opt 1 1 3 3 1 1 2 2 1 1 2 2 2 2 1 1 1 1 2 2 0 0 0 0 0 0 0 0 3 3 1 1 3 3
hint near 0
bad 1 1 3 3 1 1 2 2 1 1 2 2 2 2 1 1 1 1 2 2 0 0 0 0 0 0
corr keep going
