#########
#7#3 1#4#
# ### # #
#8#5 2  #
# ##### #
#  9   P#
# # ### #
#0#G 6# #
#########
opt 2 2 2 2 1 1
hint near 0
bad 2 2 2 2 2 2 1 1
corr s near 9
