#########
#0 9#  G#
# ### ###
#7  #1  #
### # ###
#5 4#2  #
# # # ###
#3#6 P 8#
#########
opt 0 0 0 0 0 0 2 2
hint near 1
bad 0 0 0 0 2 2
corr n near 1
