#########
#5 P 6  #
### # # #
#G#1#2#0#
# ### ###
#7#4   9#
# ### ###
#8     3#
#########
opt 2 2 1 1 1 1 1 1 3 3 3 3 0 0 0 0
hint near 1
bad 3 3
corr w near 1
