#########
#1 P#9  #
### # ###
#G# #4#0#
# # # # #
#3   8  #
# # # ###
#6#2#5 7#
#########
opt 1 1 1 1 3 3 0 0
hint near 1
bad 3 3
corr s near 1
