#########
#P#  9  #
# ### # #
#8 5 G# #
# #######
#0 6 7  #
# # ### #
#1#4 3#2#
#########
opt 1 1 2 2 2 2
hint near 5
bad 1 1 1 1 2 2 2 2 2 2
corr w near 8
