###########
# #       #
# ##### ###
#     #   #
# # # # ###
# # #     #
### ### ###
#   #     #
# ##### # #
# #  G  #P#
###########
0 0 3 3 1 1 3 3
