#########
#8# #G  #
# # # ###
#3#9 5  #
# # ### #
#  2#4 P#
# # ### #
#7#6 0#1#
#########
opt 0 0 3 3 0 0
hint near 5
bad 0 0 3 3 3 3 1 1 3 3 0 0 0 0
corr n near 5
