#########
#9 6 2 0#
### ### #
#7  #8 1#
### ### #
#P# #G  #
# # # ###
#4 3#  5#
#########
opt 1 1 2 2 0 0 0 0 0 0 2 2 2 2 1 1 1 1 3 3
hint near 8
bad 1 1 2 2
corr keep going
