#########
#     #0#
# ##### #
#4#7   8#
# ### ###
#9#G 2 6#
# ##### #
#1 5 P 3#
#########
opt 3 3 0 0 2 2 2 2
hint near 2
bad 2 2 2 2 0 0 0 0 0 0 3 3
corr e near 2
