#########
#6 0#7 G#
# ##### #
#5 2#9# #
### # # #
# #P    #
# # # # #
#8 1#4#3#
#########
opt 3 3 3 3 0 0 0 0
hint near 7
bad 0 0 2 2 0 0 3 3
corr e near 1
