#########
#  5 1#4#
### # # #
#6# #  P#
# # ### #
#9#0 7#G#
# # #####
#8 2   3#
#########
opt 1 1
hint near 3
bad 3 3 0 0 3 3 1 1 1 1 2 2
corr s near 4
