#############
#  0       6#
# ##### ### #
#4# #    3# #
### # ### ###
#     # #   #
# ### # ### #
#8  #9    # #
# # #########
#P# #1  #   #
# # # # ### #
#7#5 2#  G  #
#############
opt 0 0 2 2 1 1 1 1 2 2 0 0 2 2 1 1 2 2
hint near 2
bad 0 0 2 2 1 1 1 1 2 2
corr keep going
