#########
#   #9 5#
# ### # #
#8#  P#0#
# ##### #
#2#6 7 3#
# # ### #
#  4 G#1#
#########
opt 0 0 2 2 1 1 1 1 3 3 3 3 1 1 2 2
hint near 1
bad 0 0 2 2 1 1 1 1 3 3
corr keep going
