#########
#7#6 0 9#
# # #####
#  P#G# #
### # # #
#8 3   1#
# # ### #
#2# #4 5#
#########
opt 1 1 3 3 0 0
hint near 0
bad 1 1 3 3 3 3 0 0
corr n near 1
