#########
#4 3#   #
# # # ###
#P#6 0# #
# # # # #
#2#9#5#G#
### # # #
#1  #7 8#
#########
opt 0 0 3 3 1 1 3 3 1 1 1 1 3 3 0 0
hint near 5
bad 0 0 3 3 1 1 3 3 1 1
corr keep going
