#########
#9  #6 G#
### # # #
#P#  5#0#
# # ### #
#3 2 8# #
### ### #
#7 1#  4#
#########
opt 1 1 3 3 0 0 3 3 0 0 3 3
hint near 0
bad 1 1 3 3 0 0 0 0
corr e near 2
