#############
#    P#    4#
##### # # ###
# #   #2#   #
# ### # ### #
#G     0# # #
####### # ###
#   # # #6  #
# ### # ### #
# #  5 3    #
# # #########
#9 7 8   1  #
#############
opt 1 1 1 1 3 3 3 3
hint near 0
bad 1 1 1 1 2 2 1 1 1 1 3 3 3 3 1 1 3 3 0 0
corr e near 0
