#########
#G 5#2# #
# # # # #
#0#6#9 P#
### # ###
#  8   7#
##### ###
#  4 3 1#
#########
opt 2 2 1 1 2 2 0 0 0 0 2 2
hint near 0
bad 2 2 0 0
corr s near 9
