#########
#9#4#  3#
# # # ###
#P 5 6  #
# ##### #
#  G#7# #
# ### # #
#0 2 1#8#
#########
opt 1 1 3 3
hint near 2
bad 1 1 1 1 3 3
corr e near 0
