#############
#P        # #
##### ### # #
#0  # #2   1#
# ######### #
#       #8 9#
####### # # #
#  6  # # # #
##### # # # #
#        3#4#
# # ##### ###
#7# #  G   5#
#############
opt 2 2 2 2 2 2 2 2 1 1 2 2 1 1 3 3 1 1 1 1 1 1 3 3
hint near 3
bad 2 2 2 2 2 2 2 2 1 1 2 2 1 1 3 3 1 1 1 1 3 3 3 3 3 3 1 1
corr s near 3
