#############
#      6  # #
# ### ##### #
#  1#    8 5#
### ##### # #
#     #G  #9#
# # # # #####
# # # #   # #
# # # ##### #
#3# #4 7   0#
######### ###
#        P 2#
#############
opt 0 0 3 3 3 3 0 0 0 0 3 3 0 0 3 3 0 0 2 2 2 2 1 1 2 2 2 2 1 1 3 3
hint near 6
bad 0 0 3 3 3 3 0 0 0 0
corr keep going
