#########
#  8#P 1#
# ### ###
#0 4 7#5#
# ### # #
#G#  6 3#
### ### #
#   #2 9#
#########
opt 1 1 2 2 2 2 1 1
hint near 0
bad 1 1 1 1 2 2
corr w near 7
