#########
#6  #0 8#
# ##### #
#P  #7 5#
# # # # #
# #9 1#4#
### ### #
#3 2  #G#
#########
opt 3 3 1 1 3 3 0 0 3 3 1 1 1 1
hint near 4
bad 3 3 1 1 1 1
corr e near 9
