#########
#P 4 9  #
# # # ###
#0#1#  6#
# ### ###
#G#7 8 3#
# ### ###
# #2 5  #
#########
opt 1 1 1 1
hint near 0
bad 3 3 1 1
corr s near 0
