#########
# #3 G#6#
# # ### #
#5#2 9 1#
# # # ###
#7  #8 4#
##### ###
#P   0  #
#########
opt 2 2 2 2 0 0 0 0 3 3 0 0 2 2
hint near 3
bad 2 2 2 2 0 0 0 0
corr keep going
