#########
#P 3#7 2#
### # ###
# # #  0#
# # # ###
#6 5 4  #
# ##### #
#8#1 9 G#
#########
opt 3 3 1 1 1 1 3 3 3 3 1 1
hint near 9
bad 3 3 1 1 1 1 3 3 0 0 3 3
corr e near 4
