#############
#    8  # # #
### ### # # #
#    0#  1 5#
# # ### ### #
# # # #G#  6#
### # ### ###
#       #  7#
### ##### ###
#2 9#       #
# ##### # ###
#P 3  #4#   #
#############
opt 0 0 2 2 0 0 0 0 0 0 0 0 2 2 2 2 1 1 1 1
hint near 0
bad 0 0 2 2 0 0 0 0 0 0 0 0 2 2 2 2 1 1 2 2 2 2 1 1 3 3
corr s near 0
