#########
#1#4 2 6#
# ##### #
#3 9 7  #
### # ###
#G 5#0  #
### #####
#8 P    #
#########
opt 0 0 2 2
hint near 3
bad 0 0 0 0 2 2
corr w near 5
