#############
#6   1  # #G#
### ### # # #
#   #     # #
# ##### # # #
#     # # # #
# ##### # # #
#3   0# #   #
### ### #####
#9   2#5#  4#
### ### # # #
#  7  #8  #P#
#############
opt 0 0 3 3 1 1 3 3 0 0 0 0 0 0 0 0 2 2 1 1 1 1 2 2 0 0 0 0 0 0
hint near 1
bad 0 0 3 3 1 1 3 3 0 0 0 0 0 0 0 0 2 2
corr keep going
