#########
#9 4  #3#
### ### #
#2#  8# #
# # # # #
#G  #0#5#
# ### # #
#1#7 P 6#
#########
opt 0 0 0 0 3 3 1 1 3 3
hint near 1
bad 3 3
corr n near 0
