#########
#1#9 6 3#
# ### ###
# #8#0 G#
# # # ###
#2   P  #
# ### # #
#5 7# #4#
#########
opt 0 0 2 2
hint near 0
bad 2 2
corr n near 0
