#########
#4 5 8 9#
# #######
#  1 3# #
# # ### #
#6#  0 7#
### # # #
#  P#G#2#
#########
opt 0 0 3 3 1 1
hint near 0
bad 0 0 0 0 3 3
corr e near 0
