#############
#   # #  7  #
### # # #####
# #1 P 4    #
# # # ### ###
#G  # #3 8# #
# # ### ### #
#0# # #   # #
# # # # ### #
# # #6#   #9#
### # # ### #
#  5#2      #
#############
opt 3 3 1 1 3 3
hint near 0
bad 1 1
corr e near 1
