#########
#    8# #
### # # #
#P 9#0#G#
# # ### #
#3#4 6 2#
####### #
#  1 7 5#
#########
opt 3 3 1 1 3 3 3 3 0 0
hint near 0
bad 3 3
corr keep going
