#############
# #5 3  #   #
# # # ### # #
#   #P    # #
# ### # #####
#   #G#6#1  #
### ####### #
#7 2# #  8  #
### # ### # #
# #  9#0#4# #
# # ### ### #
#           #
#############
opt 1 1
hint near 6
bad 0 0 3 3 1 1 3 3 1 1 2 2 1 1 1 1 2 2 0 0
corr s near 3
