#############
#  9#P  # #8#
### # ### # #
# #     #2  #
# # ####### #
#6   4      #
### #########
#       #G 7#
# # ### # # #
# # #   # # #
# ### # ### #
#1#  5#0 3  #
#############
opt 1 1 3 3 1 1 1 1 2 2 2 2 1 1 1 1 2 2 2 2 0 0 0 0 3 3
hint near 7
bad 1 1 3 3 1 1 2 2 2 2 2 2
corr s near 4
