#########
#6#8 4# #
# ### # #
#7 1#2# #
### # # #
#G#5 0  #
# # ### #
#3 P#9  #
#########
opt 3 3 0 0
hint near 3
bad 0 0
corr e near 3
