#########
#9     7#
### ### #
#G#  5#0#
# ### # #
#1 P 6#3#
### ### #
#2 4#  8#
#########
opt 2 2 0 0
hint near 1
bad 1 1 2 2
corr w near 1
