#########
#9#  P  #
# # # # #
#8 5#6#3#
# #######
#0 1 7 G#
# ##### #
#4   2# #
#########
opt 3 3 1 1 3 3 1 1 2 2 2 2 2 2
hint near 3
bad 2 2
corr e near 6
