#########
#  6#  2#
# ##### #
#3 1 7  #
### #####
#  4 G 0#
# ##### #
#P#8 5 9#
#########
opt 0 0 3 3 3 3
hint near 0
bad 0 0 3 3 0 0 3 3
corr e near 4
