#########
#0 5 7 9#
### # # #
#  3#8# #
####### #
#P 4 6 2#
# # #####
# #1   G#
#########
opt 2 2 1 1 2 2 2 2
hint near 2
bad 2 2 2 2
corr s near 4
