#########
# #P#9 G#
# # # ###
#0 4#  3#
### # # #
#6   2#7#
### ### #
#  5 8#1#
#########
opt 1 1 1 1 3 3 0 0 0 0 3 3
hint near 3
bad 1 1 1 1 3 3 0 0 3 3
corr n near 2
