#########
#5 7 9  #
# ### ###
#P#  3 G#
### # ###
#  8#0  #
### # # #
#6 1#4#2#
#########
opt 0 0 3 3 3 3 1 1 3 3
hint near 3
bad 0 0 3 3 3 3 1 1 1 1 3 3
corr e near 3
