#########
#9 P 3 8#
# ### ###
#4 1#G  #
# #######
#  7#  0#
# ### ###
#6 5 2  #
#########
opt 2 2 1 1
hint near 1
bad 3 3 1 1 1 1 1 1 2 2 2 2
corr w near 1
