#########
#  3 9 6#
# ### ###
#7  #4 2#
# # ### #
#G#P#5 1#
##### ###
#8     0#
#########
opt 0 0 2 2 1 1
hint near 7
bad 0 0 2 2 0 0 3 3 3 3 1 1 3 3 1 1 2 2
corr s near 7
