#############
#3#8    #9  #
# # # ##### #
#4  #2  # # #
### # ### # #
#   #  P  #G#
##### ### # #
#     #6  # #
### ##### # #
#   #     #0#
# ####### # #
#7 5   1#   #
#############
opt 2 2 1 1 1 1 1 1 2 2 0 0 0 0 0 0
hint near 0
bad 2 2 0 0
corr s near 6
