#############
# #   #2# # #
# # ### # # #
#6 5  #  1 7#
### ### #####
#     #    0#
### # ### # #
#G# #4    # #
# ##### ### #
#    8 3  # #
# # # # # ###
# #P# # #  9#
#############
opt 0 0 3 3 0 0
hint near 4
bad 0 0 2 2 2 2 0 0 3 3 0 0 3 3 0 0 3 3
corr e near 8
