#########
#8 0#1  #
### ### #
# #6 2 3#
# # ### #
#G  #7#9#
# # # # #
# #4 P#5#
#########
opt 2 2 0 0 2 2
hint near 4
bad 0 0
corr w near 4
