#########
#7  #2 3#
### ### #
#0#6 4  #
# # # ###
#P 1#9  #
# # #####
# #5 G 8#
#########
opt 3 3 1 1 3 3
hint near 5
bad 1 1
corr e near 0
