#########
#6#5 G 8#
# # ### #
#9  #P  #
####### #
#1 7 4 2#
# ### ###
# #  0 3#
#########
opt 3 3 0 0 2 2
hint near 5
bad 3 3 1 1 2 2
corr n near 2
