#########
#6#  8  #
# # ### #
#3 7 5#1#
# ##### #
#9 P  #G#
# #######
#  4 0 2#
#########
opt 3 3 0 0 2 2 0 0 2 2 2 2 1 1 1 1
hint near 1
bad 3 3 1 1 2 2 2 2
corr n near 9
