#########
#5#6#0 9#
# # ### #
#G     1#
##### # #
#  4 P#2#
### ### #
#7 3  #8#
#########
opt 0 0 2 2 2 2
hint near 5
bad 2 2 1 1 2 2
corr n near 2
