#############
#  5     P 8#
####### ### #
#     #4# #1#
# ### # # ###
# # #G#     #
# # # ### ###
# #       #2#
### # # ### #
#  9#3#     #
######### ###
#    6 0 7  #
#############
opt 3 3 1 1 1 1 2 2 1 1 3 3 3 3 0 0
hint near 3
bad 3 3 1 1 1 1 2 2
corr keep going
