#########
#5  #2 4#
# ##### #
#8    #0#
### ### #
#P 9 6  #
# ### ###
#G 7#1 3#
#########
opt 1 1
hint near 7
bad 3 3 3 3 1 1
corr s near 8
