#############
#0#  9#     #
# # # # ### #
#6 5#  P# # #
### ##### ###
#  4  #3    #
# ##### # # #
#    1# #8# #
# ### # ### #
#   #    7# #
# ### # # # #
#   # #G#2# #
#############
opt 3 3 0 0 3 3 1 1 1 1 3 3 1 1 2 2 2 2 1 1 2 2 1 1
hint near 2
bad 3 3 0 0 3 3 1 1 1 1 3 3 1 1 1 1 1 1 2 2
corr w near 1
