#########
#    4 9#
# ##### #
#G#6   1#
##### # #
#8 2 P# #
# # #####
#5#3 7 0#
#########
opt 0 0 3 3 0 0 2 2 2 2 2 2 1 1
hint near 6
bad 2 2 2 2 1 1
corr n near 2
