#########
# #5   G#
# # #####
#P 2# #6#
# ### # #
#7#9#4 0#
# # # # #
#  3 8#1#
#########
opt 2 2 0 0 2 2 2 2
hint near 6
bad 1 1 1 1 2 2 2 2 0 0 0 0
corr w near 2
