#############
#     #   # #
# ####### # #
# #  9  #G# #
# # # ### # #
# #3#5    # #
# ##### ### #
#P  #0      #
### # ### # #
#1 6   2# # #
# ### # ### #
#7#   # #8 4#
#############
opt 2 2 1 1 2 2 0 0 2 2 0 0 2 2 0 0
hint near 9
bad 2 2 1 1 2 2 0 0 2 2 0 0 3 3 0 0
corr w near 5
