#############
# #  8# #   #
# ### # # ###
#  P  #    6#
# # ####### #
#9# # #  7# #
### # # # # #
#   #  2#   #
# ### # ### #
#0 4# # #3 G#
### # #######
#      5   1#
#############
opt 1 1 1 1 3 3 1 1 2 2 1 1 2 2 0 0 0 0 2 2 0 0 2 2 1 1 2 2 1 1
hint near 1
bad 1 1 1 1 3 3 1 1 2 2 1 1 2 2 0 0 0 0 2 2 1 1
corr n near 2
