#############
#    9#     #
# # ### ### #
# #8  # #  0#
### ##### # #
#   #     # #
### ### ### #
#   #   #  1#
# # # #######
#7#  6   3  #
# ##### #####
#  4 G#5 2 P#
#############
opt 3 3 3 3 0 0 3 3 3 3 0 0 3 3 1 1 1 1 2 2 2 2
hint near 4
bad 3 3 3 3 0 0 3 3
corr keep going
