#############
#  8  #2 0# #
# ### ### # #
# #        3#
# # ##### ###
#P#4#7#   # #
### # # ### #
# # # #G  # #
# # # ### # #
# #9# #1#6# #
# # # # # # #
#      5#   #
#############
opt 0 0 0 0 2 2 2 2 1 1 2 2 2 2 1 1 3 3 1 1
hint near 1
bad 0 0 0 0 2 2 2 2 1 1 3 3 1 1 1 1 1 1 1 1 2 2 2 2 0 0
corr w near 7
