#########
#6 2   3#
##### ###
#8#5 4 0#
# # # ###
#  G#   #
##### ###
#P 7 9 1#
#########
opt 3 3 3 3 0 0 0 0 2 2 1 1
hint near 5
bad 3 3 3 3 0 0
corr keep going
