#########
#4  # #9#
# ### # #
#1 G   5#
### #####
#8 2#3 P#
# # ### #
#0#6 7  #
#########
opt 1 1 2 2 2 2 0 0 0 0
hint near 1
bad 2 2
corr s near 3
