#########
#6 9 5  #
####### #
#1#7#4 8#
# # # ###
#    2 3#
####### #
#G 0 P  #
#########
opt 2 2 2 2
hint near 0
bad 3 3 0 0 2 2 2 2 2 2 0 0
corr w near 0
