#########
#4#2#3 6#
# # ### #
#G#P#7#8#
# # # # #
#9# #1# #
# # # # #
#    5 0#
#########
opt 1 1 1 1 2 2 0 0 0 0
hint near 4
bad 1 1
corr keep going
