#########
#7 1 3 9#
# # ### #
#4#0 P#8#
# # ### #
#6#G#   #
# ### ###
#2  #  5#
#########
opt 3 3 1 1
hint near 0
bad 3 3 0 0 3 3 1 1 1 1 1 1 2 2
corr s near 0
