#############
#    0#G    #
### ### #####
#4 3  #  2 5#
##### ### ###
#9    #    1#
##### ### ###
# #    8    #
# # # # # # #
# # # # # #6#
# # ### ### #
#7 P#   #   #
#############
opt 0 0 0 0 2 2 2 2 2 2 0 0 0 0 3 3 0 0
hint near 0
bad 0 0 0 0 2 2 0 0 0 0 3 3 0 0
corr w near 8
