#############
#    5  #0  #
##### ### # #
#     # #2# #
### # # # # #
#   #9 7  # #
### ### #####
#8  #  3 P# #
# # # ##### #
# # #G      #
### # # #####
#  1# #6 4  #
#############
opt 3 3 3 3 1 1
hint near 1
bad 3 3 0 0 3 3 0 0 3 3 1 1 1 1
corr e near 3
