#############
#     # #  7#
### # # ### #
# #5# #   # #
# # ### # # #
# #  2#9#0  #
# # # # # ###
#   #6  #   #
# # # # ### #
#G# #3# #1  #
### # ### ###
#  8#4 P#   #
#############
opt 3 3 0 0 0 0 0 0 3 3 1 1 3 3 1 1
hint near 3
bad 3 3 0 0
corr keep going
