#########
#0#8 P#5#
# # ### #
#G 6   4#
# # ### #
#7#9#   #
##### # #
#  3 1#2#
#########
opt 3 3 1 1 3 3
hint near 0
bad 3 3 1 1 2 2 2 2 1 1 3 3 1 1 3 3 3 3
corr e near 6
