#############
# #  8      #
# # ####### #
#    G#  6# #
####### # # #
#0 5  # #3  #
##### # #####
# #9#2      #
# # ### ### #
# #     # #1#
# # # ### # #
#  P#4  #  7#
#############
opt 0 0 2 2 2 2 0 0 0 0 0 0 2 2 1 1 2 2 0 0 0 0 3 3 3 3 3 3 3 3 1 1 2 2
hint near 8
bad 0 0 2 2 2 2 0 0 3 3
corr n near 2
