#########
#2 4#3 P#
# # # ###
#7#5 0 1#
##### ###
#8      #
# ##### #
#  9#G 6#
#########
opt 3 3 1 1 1 1 2 2 1 1 3 3
hint near 6
bad 3 3 1 1 1 1 3 3 3 3 1 1 2 2
corr w near 0
