#########
#8 2 5  #
# ##### #
#0#  P 1#
### # ###
#G  #7 4#
##### ###
#6 3 9  #
#########
opt 2 2 1 1 2 2
hint near 0
bad 3 3 0 0 2 2 2 2 2 2
corr w near 1
