#########
# #  4 3#
# # # ###
# #6#G  #
# # ### #
#2 5#7 P#
# ### # #
#0#9 8#1#
#########
opt 0 0 2 2
hint near 4
bad 2 2
corr n near 1
