#########
#4 0 6  #
# # ### #
# # #3#G#
### # ###
#8 1 2 5#
# ### ###
#9#7   P#
#########
opt 2 2 0 0 2 2 0 0 0 0 3 3 3 3 1 1
hint near 3
bad 2 2 0 0 3 3
corr w near 2
