#############
#    6#     #
### ### # # #
#3  # #5#G# #
# ### ##### #
# #   #     #
# ### # #####
#8   9#   #4#
# # ##### # #
#2#  0   1 7#
##### # ### #
#     #P  # #
#############
opt 0 0 2 2 0 0 3 3 0 0 2 2 2 2 0 0 0 0 3 3 1 1
hint near 5
bad 0 0 2 2 0 0
corr keep going
