#############
#   # #7  #0#
# ### # ### #
#   #1 6 9#3#
### ### ### #
# #  2#   #G#
# # ### # # #
#  P#  5#   #
# # # ##### #
# #8#     # #
# # # ##### #
# #   #4    #
#############
opt 1 1 1 1 2 2 0 0 0 0 2 2 0 0 2 2 1 1 2 2 0 0
hint near 3
bad 1 1 1 1 2 2 0 0 0 0 2 2 0 0 2 2
corr keep going
