#########
#  P# # #
# # # # #
#7#5 2 0#
# ##### #
#6 1#G  #
### ### #
#4 3#9 8#
#########
opt 1 1 2 2 2 2 1 1 3 3
hint near 1
bad 1 1 2 2
corr keep going
