#############
#6#  7      #
# # ### # ###
#   #9  # # #
# ####### # #
#5 G#0# #   #
# ### # # ###
# #   # #   #
# # # # # ###
#3 8#2  #P  #
# # # # # ###
# #4#1# #   #
#############
opt 0 0 0 0 0 0 0 0 3 3 3 3 3 3 1 1 3 3 1 1 2 2
hint near 0
bad 0 0 0 0 0 0 0 0 3 3 3 3 3 3 1 1 3 3 1 1 1 1 1 1 2 2 0 0 2 2 0 0
corr w near 5
