#########
#0 P   5#
# ##### #
#4#   #8#
# ### # #
#G#6 3 1#
# ##### #
#9 7#  2#
#########
opt 3 3 1 1 1 1
hint near 4
bad 2 2 2 2 1 1 1 1 3 3
corr e near 0
