#########
# #5 0  #
# # ### #
# #G#8 9#
# ##### #
#2 7   P#
# # # ###
#4#1#3 6#
#########
opt 0 0 0 0 2 2 2 2 1 1
hint near 5
bad 2 2 2 2 2 2
corr n near 6
