#############
#  8 9      #
####### ### #
#1     5 6# #
# ### # # ###
# #4 0# # # #
##### ### # #
#G 2#   # # #
### ##### # #
#           #
####### ### #
#  7   3 P# #
#############
opt 3 3 0 0 3 3 3 3 0 0 3 3
hint near 2
bad 3 3 0 0 2 2 0 0 0 0 0 0 3 3 3 3 1 1 3 3
corr e near 3
