#############
# # #7  #   #
# # ### # ###
#  P 2# #   #
# ### # # ###
#4#         #
##### ##### #
# # # #G#   #
# # ### # ###
#5 6 3   1# #
# # ### ### #
#9# #0     8#
#############
opt 2 2 1 1 2 2 2 2 2 2 1 1 3 3 1 1 3 3 0 0
hint near 1
bad 2 2 1 1 2 2 2 2 2 2 1 1 3 3 1 1 3 3 3 3 3 3 0 0
corr n near 1
