#########
#7 6# #9#
# ### # #
#P 4 1 5#
### # ###
#G# #0  #
# ### ###
#2 3 8  #
#########
opt 2 2 2 2 1 1 1 1 3 3 3 3 0 0
hint near 2
bad 2 2 1 1
corr w near 4
