#########
#P#0    #
# # # ###
#8#7#6 1#
# ### ###
#  3 5 G#
# ### # #
#9#4 2# #
#########
opt 1 1 1 1 3 3 3 3 3 3
hint near 1
bad 1 1 1 1 3 3 3 3 0 0 0 0 3 3
corr e near 5
