#########
#9 G 8# #
### ### #
#  6#P 7#
# ##### #
#3   1 4#
### #####
#2   5 0#
#########
opt 3 3 1 1 2 2 2 2 2 2 0 0 3 3 0 0
hint near 6
bad 3 3 1 1 2 2 2 2
corr keep going
