#########
#6 8#  P#
# # # ###
#7#G#9#2#
### # # #
#3 1# #5#
# # # # #
# #0 4  #
#########
opt 2 2 1 1 1 1 1 1 2 2 0 0 0 0
hint near 1
bad 2 2
corr keep going
