#############
# #P#5#     #
# # # ### ###
#         # #
# ##### ### #
#7#4 3  #   #
### ### # ###
#6 9#   #G# #
##### ### # #
#        8#2#
# ####### # #
#1     0#   #
#############
opt 1 1 2 2 2 2 1 1 1 1 3 3 1 1 2 2 2 2 0 0
hint near 8
bad 1 1 2 2 2 2 1 1
corr keep going
