#########
#    7  #
##### ###
#1 3 6 P#
# # #####
# #0 G 2#
# #######
#9 8 5 4#
#########
opt 3 3 3 3 1 1 2 2
hint near 0
bad 3 3
corr keep going
