#########
#4#7 8  #
# # # # #
# #9#2# #
# ### ###
#0 3 G 5#
### ### #
#6  #1 P#
#########
opt 0 0 3 3
hint near 1
bad 3 3
corr n near 1
