#########
#0# #G#6#
# # # # #
#1   7 5#
# ##### #
#9 3#  4#
# # # # #
#8# #P#2#
#########
opt 0 0 2 2 0 0 3 3 0 0
hint near 6
bad 0 0 2 2 0 0 3 3 3 3 3 3 0 0
corr n near 7
