#########
#    P 9#
### ### #
#8  #2 G#
### #####
#4   0#7#
# # # # #
#6#3#5 1#
#########
opt 3 3 1 1
hint near 2
bad 2 2 1 1 1 1 3 3 1 1 3 3 0 0
corr e near 2
