#############
#   #   #6  #
# # # # ### #
# # #G#4  # #
# ### # # # #
#  1  # #   #
### ### ### #
#P 7 2#8# # #
# ####### # #
# #    0   3#
### ### # # #
#5    # # #9#
#############
opt 2 2 0 0 2 2 0 0
hint near 4
bad 2 2 0 0 3 3 0 0
corr w near 1
