#############
#       #7  #
### ### ### #
#G 0#6   4  #
### ####### #
# # #P  #   #
# # # ##### #
#     #  8# #
# ####### ###
#9  #  2 3 5#
# ### ### # #
#     #  1# #
#############
opt 1 1 3 3 0 0 0 0 3 3
hint near 0
bad 1 1 3 3 0 0 0 0 0 0 2 2 2 2 1 1 3 3
corr e near 0
