#########
#5 6#0  #
# # ### #
#7#2#1 4#
# ### # #
#  9#G# #
# # # ###
#8#  3 P#
#########
opt 2 2 0 0
hint near 1
bad 2 2 2 2 0 0 2 2 0 0 0 0 3 3 1 1
corr n near 3
