#########
#3   2 5#
### ### #
#0 P  #8#
### # ###
#9 6#  7#
# ### ###
#  4#G 1#
#########
opt 2 2 1 1 1 1
hint near 1
bad 1 1 3 3 1 1 2 2
corr w near 0
