#########
#4 9   5#
##### ###
#P#1#3  #
# # # ###
#  6 7 G#
### # # #
#2 0# #8#
#########
opt 1 1 2 2 2 2 2 2
hint near 7
bad 1 1 2 2 2 2 0 0 2 2
corr w near 7
