#############
#  0#6#     #
# # # ### ###
# #   #P   8#
### # # ### #
#  G#  9 5# #
######### ###
#  7        #
# ### # # ###
# #  3#1#2# #
# ### ### # #
# #     #  4#
#############
opt 1 1 3 3 0 0 3 3 1 1
hint near 7
bad 1 1 2 2 1 1 3 3 3 3 1 1 3 3
corr e near 9
