#########
#9#8 1#0#
# ### # #
#  5 6 4#
##### # #
#  G  #7#
##### # #
#P   3#2#
#########
opt 3 3 3 3 0 0 2 2
hint near 5
bad 3 3 3 3 0 0 0 0 3 3 1 1
corr w near 3
