#########
#6 1#2#9#
### # # #
#5#  0#8#
# # ### #
#P#4 3 G#
# ### ###
#  7    #
#########
opt 1 1 3 3 3 3 0 0 3 3
hint near 3
bad 1 1 3 3 3 3 3 3
corr n near 3
