###########
#G   P    #
####### # #
#       # #
####### ###
#       # #
# ####### #
#   # #   #
# ### ### #
#         #
###########
3 3 3 3
