#########
#1#7#4#0#
# # # # #
#3 G 8 9#
### #####
# # #2#5#
# # # # #
#  P 6  #
#########
opt 0 0 0 0
hint near 3
bad 3 3 0 0
corr n near 6
