#########
#P 4 3  #
# ### # #
#0#   #5#
# # ### #
#6#9#7# #
# # # ###
#2#G 8 1#
#########
opt 2 2 2 2 1 1 3 3 1 1 1 1
hint near 2
bad 1 1 1 1
corr w near 0
