#########
#    5#P#
# # ### #
#2#  1 0#
### ### #
#3 8 7#4#
##### # #
#9   6#G#
#########
opt 1 1 1 1 1 1
hint near 4
bad 1 1 2 2 2 2 1 1 3 3
corr s near 0
