#########
#P#9 2  #
# # ### #
#8   6#G#
##### ###
#4   7 5#
# # # # #
#3#0#1# #
#########
opt 1 1 2 2 0 0 2 2 2 2 1 1
hint near 5
bad 1 1 2 2 2 2 1 1 2 2
corr n near 6
