#############
#  4#2#     #
# ### # #####
# #G 9#1    #
# # # # ### #
#8  #6#3  # #
# ### # # ###
#   # # #P# #
# ### ### # #
#  7#     # #
# # ### ### #
# # #5     0#
#############
opt 1 1 3 3 3 3 0 0 0 0 0 0 3 3
hint near 4
bad 0 0 3 3 0 0
corr s near 3
