#########
#3 P#6 0#
### ### #
#9     8#
# ### ###
#2#G#  4#
### # # #
#7 5 1# #
#########
opt 1 1 2 2 1 1 1 1 3 3 0 0
hint near 2
bad 1 1 2 2 1 1
corr keep going
