#########
#  7 4 2#
# # #####
#9#  6#0#
# # ### #
#G#5 1 8#
### ### #
#  3#  P#
#########
opt 0 0 3 3 3 3 0 0 0 0 3 3 1 1 1 1
hint near 5
bad 0 0 3 3 3 3 0 0
corr keep going
