#########
#0#7 G 5#
# # #####
#8   1# #
# # ### #
# #4#9 3#
# # ### #
# #2 P 6#
#########
opt 3 3 0 0 0 0 0 0 2 2
hint near 1
bad 2 2 0 0 3 3
corr e near 2
