#########
#5 3 P#6#
##### # #
#  1 4 2#
# ### # #
#9 G#7#0#
### ### #
#  8#   #
#########
opt 1 1 3 3 3 3 1 1 2 2
hint near 1
bad 1 1 2 2 1 1 1 1 3 3
corr e near 4
