#############
#   #P# #   #
# # # # ### #
#5#  6  #0# #
### # ### # #
# #2#    7#4#
# # # # ### #
# # # #    1#
# # ##### ###
#    G#   #8#
# ### ##### #
# #9       3#
#############
opt 1 1 3 3 1 1 1 1 1 1 2 2
hint near 9
bad 1 1 1 1 2 2 1 1
corr e near 6
