#########
#G#5  #9#
# ### # #
#P#  7#0#
# # # # #
#8 2#   #
# ##### #
#1 3#4 6#
#########
opt 0 0
hint near 5
bad 1 1 3 3 0 0 3 3 0 0 2 2
corr n near 8
