#########
#2#1 4#P#
# ### # #
#5   7  #
# ##### #
#6#9#0# #
# # # # #
#3#8 G  #
#########
opt 1 1 1 1 1 1 3 3
hint near 0
bad 1 1 3 3 3 3 3 3 1 1 1 1
corr s near 7
