#########
#1#8 0 5#
# # # ###
#7#9#6 P#
# # ### #
#4 3 2# #
### #####
#    G  #
#########
opt 2 2 0 0 2 2 1 1 1 1 1 1 3 3
hint near 2
bad 2 2
corr keep going
