#############
# # #    0# #
# # # # ### #
#1   3#    P#
# # ##### ###
#7# # #    2#
##### ##### #
# #  9#G# # #
# # # # # # #
#4  # #    8#
# # ### #####
# #6     5  #
#############
opt 3 3 1 1 2 2 1 1 1 1 3 3 3 3 0 0
hint near 9
bad 3 3 1 1 2 2 1 1
corr keep going
