#########
#0 P 4#G#
# ### # #
# #8#7  #
# # # ###
#5#2 9  #
##### ###
#3 6 1  #
#########
opt 2 2 1 1 2 2 0 0
hint near 4
bad 2 2 1 1 1 1 2 2
corr w near 7
