#########
#4#7 P#2#
# # # # #
#  0#8#3#
# ### # #
#G 5# #9#
##### # #
#6 1    #
#########
opt 3 3 1 1 3 3 1 1
hint near 5
bad 1 1 1 1 1 1 3 3 3 3
corr e near 2
