#########
#1 6 2 5#
### #####
#  3 9 G#
### # # #
# #4#0#8#
# # ### #
#7 P#   #
#########
opt 0 0 0 0 2 2 2 2
hint near 5
bad 0 0 0 0 0 0 2 2
corr w near 3
