#############
#2#       # #
# ### # ### #
# # #6#0   1#
# # # #######
#     # #   #
# ### # # ###
#8# #7#  G# #
# # ### ### #
#  5   4#   #
### ### # ###
#  9#  3   P#
#############
opt 3 3 3 3 0 0 0 0 2 2
hint near 4
bad 3 3 0 0 2 2 0 0
corr e near 3
