#########
#  8 0 7#
### #####
#1 3 9 2#
# # ### #
#P# #G  #
### #####
#  5 6 4#
#########
opt 0 0 3 3 3 3 3 3 1 1 2 2
hint near 6
bad 0 0 3 3 1 1 1 1 3 3
corr e near 3
