#########
# #9   5#
# # #####
# #8#G  #
# # # # #
#P#6#7#0#
# # ### #
#3 4 2 1#
#########
opt 1 1 2 2 2 2 2 2 0 0 0 0 3 3
hint near 7
bad 1 1 2 2 0 0 0 0 0 0
corr w near 4
