#############
#      6#0  #
##### ### # #
#   # #P 4#2#
### # ### ###
#   #   # # #
### # ### # #
#        9  #
##### # # # #
#1    #5# #7#
##### # ### #
#  8  #3#  G#
#############
opt 2 2 1 1 1 1 2 2 1 1 1 1
hint near 7
bad 2 2 1 1 1 1 1 1
corr w near 9
