#########
#4 2#8  #
### # ###
#6 P G  #
# ### ###
#5#7#3  #
# # #####
#1 0 9  #
#########
opt 2 2
hint near 3
bad 3 3 1 1 1 1 2 2 2 2
corr w near 2
