#########
#2 6#G 1#
# ### ###
#5#9   4#
# ### ###
#0  #P 8#
### # # #
#  3 7# #
#########
opt 0 0 0 0
hint near 1
bad 1 1 3 3 0 0 3 3 0 0 0 0 2 2
corr n near 7
