#############
#P# #       #
# # # # ### #
#  5  #0#2  #
### # # #####
#  7# #G    #
##### # #####
#   # #1   6#
### ### #####
#  4       3#
##### # ### #
#     #8#9  #
#############
opt 1 1 2 2 2 2 0 0 2 2 1 1 1 1
hint near 0
bad 1 1 2 2 2 2 0 0 2 2 2 2 2 2 1 1 3 3
corr s near 0
