#########
#9 8#5 0#
# # # ###
#1#  P 6#
# # ### #
#7#G#   #
##### # #
#4 3 2# #
#########
opt 2 2 1 1
hint near 3
bad 2 2 0 0 2 2 1 1 1 1
corr s near 1
