#########
#9 3 5 4#
####### #
# #1#G  #
# # ### #
#6 7    #
####### #
#8 P 0 2#
#########
opt 2 2 2 2 0 0 0 0 3 3
hint near 1
bad 2 2 2 2 0 0 3 3 3 3 3 3 0 0
corr n near 2
