#########
#4 P 9 G#
# # #####
#3#0  #7#
# ##### #
#1 2  # #
# ### # #
#8  #6 5#
#########
opt 3 3 3 3
hint near 7
bad 2 2 1 1 1 1 3 3 3 3 1 1 3 3 0 0 0 0
corr e near 0
