#############
#0#    G#4# #
# ### ### # #
#   # #P   7#
# # # # # ###
# #5   6#   #
### ### #####
#   #  2    #
####### # ###
#8# #   #   #
# # ### ### #
#  3     9#1#
#############
opt 1 1 3 3 0 0 0 0 2 2
hint near 4
bad 2 2 0 0
corr s near 6
