#############
# #2      # #
# # # ### # #
#4 0# #G   9#
### # #######
#   #1    #P#
##### ##### #
# # #   #7  #
# # # # ### #
#  3  #  8# #
##### # # # #
#  5  # #6  #
#############
opt 1 1 1 1 1 1 3 3 0 0 3 3 0 0 3 3 0 0 0 0 0 0 2 2 2 2 1 1 3 3
hint near 0
bad 1 1 1 1 1 1 3 3 0 0 3 3 0 0
corr keep going
