#########
#8 0 G 3#
# # ### #
#7# #4 2#
# # #####
#1#  6  #
### ### #
#  P#5 9#
#########
opt 0 0 0 0 0 0 3 3
hint near 0
bad 0 0 3 3
corr n near 1
