#########
#1#0#3 5#
# # # # #
#  4#G# #
# ### ###
#P 2#8 9#
### # # #
#7 6  # #
#########
opt 3 3 1 1 3 3 0 0 0 0
hint near 3
bad 0 0 3 3 0 0
corr e near 2
