#########
#P   8#G#
# ### # #
#9 7#1#0#
### ### #
#5   2  #
####### #
#  6 3 4#
#########
opt 1 1 3 3 1 1 3 3 3 3 0 0 0 0
hint near 0
bad 3 3 3 3
corr s near 9
