#########
#  2#0 P#
# ### # #
#  6#G#3#
# ##### #
#1 9  #8#
##### # #
#5 7   4#
#########
opt 3 3 1 1
hint near 0
bad 1 1
corr e near 0
