#############
#   #  5#  1#
### # # ### #
#2    #  9  #
##### ### # #
#  G# #4 3# #
### ##### # #
#   #   # #6#
# ##### # ###
#7# #8#   # #
# # # ### # #
#    P 0    #
#############
opt 3 3 3 3 0 0 0 0 2 2 0 0
hint near 2
bad 2 2 2 2 0 0 0 0 0 0 0 0 3 3 0 0 3 3 1 1
corr e near 0
