#########
#G#5   3#
# ##### #
#2   7# #
### ### #
#6 P 8 4#
### ### #
#0   9#1#
#########
opt 0 0 3 3 0 0
hint near 2
bad 2 2 2 2 0 0 0 0 3 3 3 3
corr n near 6
