#########
# #  1 8#
# # # ###
#P 4#  0#
# ### # #
#3 7# #9#
### # # #
#6 2#G#5#
#########
opt 3 3 0 0 3 3 1 1 1 1 1 1
hint near 2
bad 1 1 3 3
corr e near 3
