#########
#8#2 3 1#
# ### ###
#5#    6#
# # ### #
#4    #9#
### ### #
#7 P#0 G#
#########
opt 0 0 0 0 3 3 3 3 1 1 1 1
hint near 0
bad 0 0 3 3
corr n near 4
