#############
#2  #  3  #7#
### ### ### #
#0  #     #P#
### ##### # #
#6  #5#     #
# # # ##### #
# # # # #G  #
### # # # # #
# #   #9# #8#
# ### # # # #
#        4#1#
#############
opt 1 1 1 1 3 3
hint near 4
bad 1 1 3 3
corr s near 7
