#############
#   #       #
# ##### #####
#5   4# #   #
# ### # ### #
# #3        #
### # # # ###
#   # #9#   #
##### ### ###
#  2  #G   P#
# ### # # # #
#0#  6#8#1#7#
#############
opt 3 3 3 3
hint near 8
bad 3 3 0 0 0 0 3 3 1 1
corr e near 1
