#########
#P   1 3#
### ### #
#0#4  #G#
# ### ###
#8 2 7 9#
# # # ###
# #5#6  #
#########
opt 3 3 3 3 3 3 1 1
hint near 3
bad 3 3 1 1
corr e near 1
