#############
#7#      2# #
# # ####### #
#8    #  1  #
### # # ### #
#   #   # #P#
######### # #
#5#  9#G 4  #
# # # ### ###
#  0#       #
####### # ###
#6   3  #   #
#############
opt 1 1 3 3 3 3
hint near 4
bad 1 1 3 3 1 1 3 3 3 3 0 0
corr e near 4
