#########
#7#9#5# #
# # # # #
#1  #3 0#
### # # #
# # #G#P#
# # ### #
#8 2 6 4#
#########
opt 0 0 2 2 1 1
hint near 3
bad 1 1 2 2
corr n near 0
