#############
#    G# #   #
##### # ### #
#1#   # #   #
# ### # ### #
# # # # #7#5#
# # # # # # #
#  8     6  #
### ### # ###
# #3 0# #   #
# # ####### #
#9 P 2#4    #
#############
opt 0 0 0 0 2 2 0 0 0 0 0 0
hint near 1
bad 0 0 0 0 2 2 2 2 2 2 2 2 0 0 0 0 0 0 3 3
corr n near 0
