#########
#G#8 2 3#
# ##### #
# # #P 4#
# # # ###
#6 7  #1#
# # # # #
#9#5#  0#
#########
opt 1 1 2 2 2 2 0 0 0 0
hint near 8
bad 3 3 0 0 2 2
corr s near 2
