#############
#6#2  # #G# #
# # ### # # #
# #P 4#    9#
# # # # #####
#   #     # #
# # # ### # #
# #1#   #3  #
# ##### ### #
# #7      # #
# # ####### #
# #    5#8 0#
#############
opt 2 2 1 1 2 2 0 0 2 2 0 0
hint near 9
bad 0 0 2 2
corr w near 2
