#########
#2 8#3 7#
### ### #
#  6   1#
### #####
#0#5 G  #
# # # ###
#P 4#9  #
#########
opt 3 3 0 0 3 3
hint near 5
bad 3 3 0 0 0 0 3 3 3 3 0 0 2 2
corr e near 5
