#########
#6   2 P#
### # ###
#  1#  5#
# ##### #
#8#G#7 9#
# # ### #
#0#  3 4#
#########
opt 2 2 1 1 3 3 1 1 1 1 2 2 2 2 0 0
hint near 1
bad 2 2 2 2 1 1 2 2
corr s near 2
