#########
#G#  7  #
# # ### #
#  8 6#0#
### #####
#  9 5 3#
# # # ###
#4#2#P 1#
#########
opt 0 0 3 3 0 0 3 3 0 0
hint near 7
bad 0 0 3 3 3 3
corr n near 9
