#############
# #     #P  #
# # ### ### #
#7   8# # #9#
# ####### # #
#4    #3    #
# # ### #####
# # #1     5#
# # # # # # #
# #   # #0#G#
# ##### ### #
#2  #  6  # #
#############
opt 2 2 1 1 1 1 3 3 3 3 1 1 2 2 2 2 1 1
hint near 0
bad 2 2 1 1 1 1 3 3 3 3 1 1 2 2 1 1
corr w near 0
