#########
#4  #2 G#
### # ###
#9 1 3 6#
# ### # #
# #7# #5#
# # ### #
#0 8  #P#
#########
opt 0 0 0 0 3 3 0 0 2 2
hint near 2
bad 0 0 0 0
corr keep going
