#############
#2   8  #9 3#
##### ##### #
#1 5#   #6  #
### ### # ###
#    G  #   #
# ### # # # #
# #   #   #P#
# # # ### ###
# # #4#    0#
### ##### # #
#      7# # #
#############
opt 0 0 3 3 1 1 3 3 0 0 3 3
hint near 4
bad 0 0 3 3 1 1 3 3 0 0 0 0 3 3
corr e near 6
