#########
#2#  1 9#
# ##### #
#  6 G#7#
##### # #
#P 5 3#0#
### # # #
#4 8#   #
#########
opt 2 2 2 2 0 0
hint near 1
bad 2 2 2 2 1 1 2 2 0 0 0 0 0 0 3 3 3 3
corr n near 3
