#############
#4   P      #
######### # #
#       #7# #
### ### # ###
# #9#      5#
# ### ### ###
#   #  0#1 G#
### # #######
#2  #  6    #
# # # # # # #
# #  8# # #3#
#############
opt 2 2 2 2 1 1 1 1 1 1 2 2
hint near 1
bad 2 2 2 2 1 1 1 1 3 3 3 3 1 1 2 2
corr s near 1
