#############
#  2 6#P 8# #
# ### # ### #
#  1# #    5#
# ### ##### #
#   #       #
### # ### ###
#7  #   #   #
# ### # # # #
#  9# #0# # #
# # # ### # #
# # #3  #G#4#
#############
opt 1 1 2 2 2 2 1 1 3 3 1 1 1 1 1 1
hint near 4
bad 1 1 2 2 2 2 1 1 3 3 3 3 3 3 1 1 1 1 1 1 2 2
corr s near 5
