#############
# #  9 6#  5#
# # # # # ###
#   # #     #
# ######### #
#   #P#   # #
# ### # # # #
#  8 0# #7#1#
### ### # ###
# #    4#  3#
# # ####### #
#    2 G  # #
#############
opt 1 1 3 3 1 1 1 1 2 2 2 2
hint near 2
bad 1 1 3 3 1 1 2 2 2 2 0 0 0 0 2 2 1 1 1 1 2 2 1 1
corr s near 8
