#########
#3#G 9 4#
# ##### #
#    0 6#
# ### ###
#8  #P#5#
# ### # #
#7 2#1  #
#########
opt 0 0 3 3 0 0 2 2 2 2
hint near 3
bad 0 0
corr keep going
