#############
#1 0#2    # #
### # ##### #
#4         9#
# ### # #####
#5  # #3 G  #
# ##### # ###
# #   # #   #
# # ### #####
#7#   # #8  #
# # ### # ###
#6  #P      #
#############
opt 2 2 0 0 0 0 0 0 2 2
hint near 3
bad 2 2 0 0 0 0 0 0 0 0 3 3 0 0 2 2 2 2
corr w near 3
