#########
#  1 5 0#
####### #
#  4 2  #
# # # ###
#9#6#P 7#
# ### # #
#8#G  #3#
#########
opt 1 1 3 3
hint near 6
bad 0 0 3 3 1 1
corr s near 2
