#############
# #      G# #
# ##### # # #
#1 3#0#P#   #
# # # # #####
# #     #   #
##### # # ###
#  8# # #  4#
### ### # # #
#  5      # #
# # ### # ###
# #9#2  #6 7#
#############
opt 0 0 2 2
hint near 0
bad 1 1 1 1 1 1 2 2 0 0 0 0
corr n near 0
