#############
#         # #
### ### ### #
#  4#G   P  #
# ##### ### #
# # # #2# # #
### # # # # #
#  0  #   # #
### ### ### #
#9 6 5  #8  #
### ### # # #
#1   7#3# # #
#############
opt 3 3 3 3
hint near 4
bad 3 3 1 1 1 1 1 1 3 3 3 3 0 0 0 0
corr e near 2
