#########
#8#P#3#1#
# # # # #
#G 6 5 4#
### ### #
#9 2#  7#
### # # #
#   # #0#
#########
opt 1 1 2 2
hint near 6
bad 1 1 1 1 1 1 2 2
corr w near 6
