#########
#8 5 0 9#
### #####
#7   1 G#
##### ###
#  P 4 6#
# # # ###
# #3#  2#
#########
opt 2 2 0 0 2 2
hint near 1
bad 2 2 2 2
corr n near 4
