#########
#3 7   5#
# #######
#  G# # #
# ### # #
#4 1 6 2#
##### ###
#8 9 0 P#
#########
opt 2 2 0 0 2 2 2 2 0 0 3 3
hint near 1
bad 2 2 0 0 3 3 0 0
corr w near 6
