#########
#7#2 G 3#
# # # # #
# #4#9# #
# # ### #
#8  #0 6#
# # ### #
#P#1  #5#
#########
opt 0 0 3 3 0 0 0 0 3 3
hint near 2
bad 0 0 0 0 0 0
corr e near 8
