#############
# #   #  7 1#
# # ### # ###
#   #   # #G#
# ##### ### #
#          8#
# # ### # # #
#9# #6 0# # #
# ### #######
#4  # # #P  #
# ### # # ###
#3 2#  5    #
#############
opt 1 1 3 3 3 3 0 0 0 0 2 2 0 0 2 2 2 2 0 0
hint near 1
bad 1 1 3 3 3 3 0 0 0 0 2 2 0 0 0 0
corr w near 0
