#########
# #G P#7#
# ### # #
#1 3 5 9#
# ### ###
#8  #   #
### # ###
#4 2#0 6#
#########
opt 2 2
hint near 3
bad 1 1 2 2 2 2 0 0
corr w near 5
