#########
#  P 9  #
# #######
#4 1 3#8#
# ### # #
#2 5#   #
# ### # #
#7#6 G#0#
#########
opt 2 2 1 1 3 3 3 3 1 1 1 1
hint near 0
bad 2 2 1 1 1 1 3 3
corr e near 4
