#########
#2#P#1 0#
# # ### #
#4   3#5#
##### # #
#G#7 9  #
# # #####
#    6 8#
#########
opt 1 1 2 2 1 1 3 3 1 1 3 3 0 0
hint near 4
bad 1 1 3 3
corr w near 3
