#########
#  4 9  #
##### ###
#3 2 0 7#
##### # #
#  G 1#5#
# # ### #
# #8 6#P#
#########
opt 0 0 0 0 2 2 1 1 2 2
hint near 1
bad 0 0 0 0 2 2 0 0 2 2
corr s near 0
