#############
# #  7#9  # #
# ### # ### #
#8#G    # #0#
# # ### # # #
#P# #    5# #
# ### ### # #
#     #     #
# ### ##### #
#   #  6  #2#
# ### ##### #
#1 3# #  4  #
#############
opt 1 1 2 2 2 2 0 0 2 2 0 0 3 3 3 3
hint near 8
bad 0 0
corr s near 8
