#########
#   #9#P#
### # # #
#5    #6#
##### # #
#1 4 2 0#
##### ###
#G 7 8 3#
#########
opt 1 1 1 1 3 3 1 1 3 3 3 3
hint near 1
bad 1 1 1 1 3 3 3 3
corr s near 2
