#############
#P 3#   #   #
### # ### ###
# #  0 8  # #
# # ### ### #
#    1#    2#
####### ### #
#9#7    # # #
# ### ### ###
#   #      5#
# ##### ### #
#  4   G 6# #
#############
opt 2 2 1 1 2 2 2 2 1 1 1 1 3 3 1 1 2 2 1 1
hint near 6
bad 2 2 1 1 2 2 2 2 1 1 1 1 3 3 1 1 2 2 2 2 2 2 1 1
corr s near 5
