#########
#  7#  2#
# # # ###
#6#9 5#0#
# ### # #
#3#  P G#
# # #####
#8#4 1  #
#########
opt 3 3
hint near 0
bad 2 2 1 1 3 3 3 3
corr e near 1
