#########
#2 1#  9#
### # ###
#8   0 6#
# # ### #
# #  7#P#
# #######
#G 3 4 5#
#########
opt 0 0 2 2 2 2 2 2 1 1 1 1
hint near 3
bad 0 0 2 2 2 2 1 1
corr w near 0
