#############
#P  # #6    #
# # # # #####
# #       #G#
### # ##### #
#   # # #1#5#
### ### # # #
#  3#9   2  #
### # ### # #
#      8#7# #
# # # # #####
# #0#4#     #
#############
opt 2 2 1 1 1 1 1 1 1 1 2 2 0 0 2 2 2 2 2 2 0 0 0 0
hint near 5
bad 2 2 1 1 2 2 2 2 0 0 2 2 2 2
corr s near 3
