#############
#G    # #0 2#
### ### ### #
#   #P#6    #
### # # ### #
#      1#5# #
### ##### # #
#     #8#  7#
# ### # ### #
#   # #   # #
##### # # ###
#  3    #4 9#
#############
opt 1 1 3 3 0 0 0 0 3 3
hint near 0
bad 1 1 3 3 0 0 3 3
corr n near 6
