#########
#5#G#P#7#
# # # # #
#0 2  # #
# ##### #
#1 4 3  #
# ##### #
#6 9#  8#
#########
opt 1 1 3 3 0 0
hint near 2
bad 1 1 3 3 3 3 1 1 2 2 2 2 2 2 0 0 0 0
corr n near 2
