#########
#P#  3 1#
# ##### #
#2#5 7 0#
# # ### #
#8 6  # #
##### ###
#4 9 G  #
#########
opt 1 1 1 1 2 2 2 2 1 1
hint near 9
bad 1 1 1 1 2 2 0 0 2 2 2 2 1 1
corr w near 6
