#############
#    2#1    #
##### ### ###
#G# #       #
# # ### #####
# #6 P 0    #
# # # #######
#7# #  3    #
# # ### # # #
#     #9#8#5#
# ######### #
#     #    4#
#############
opt 3 3 1 1 1 1 3 3 0 0 0 0 0 0
hint near 6
bad 2 2 0 0 3 3
corr e near 0
