#############
#8      #  5#
### # ##### #
#   #   #   #
# ### # # ###
#G 1#7#    6#
####### # ###
#P#  0  #  4#
# # # ### # #
#   # #  9# #
### ####### #
#2  #  3    #
#############
opt 1 1 2 2 0 0 2 2 2 2 0 0 0 0 3 3 0 0 3 3 1 1 3 3 1 1
hint near 1
bad 1 1 2 2 0 0
corr keep going
