#############
#    5 7   6#
######### # #
# #  9   8# #
# # ##### ###
#     #  3# #
### ### ### #
#  0  #     #
### ####### #
#    4 P#  1#
# # # ##### #
# #G# #    2#
#############
opt 3 3 3 3 1 1
hint near 0
bad 3 3 3 3 3 3 1 1
corr s near 0
