#########
#  3#5  #
# # # # #
#7#4 G#6#
### ### #
#1 0  #9#
# # # ###
#2# #8 P#
#########
opt 3 3 0 0 3 3 0 0 2 2
hint near 4
bad 3 3 0 0 3 3 0 0 0 0 3 3 1 1
corr w near 4
