#########
#3  # #4#
# # # # #
# # #2 6#
### # # #
#7 0 G#1#
### ### #
#9 8 5#P#
#########
opt 0 0 0 0 2 2 1 1
hint near 0
bad 0 0
corr keep going
