#########
#G#4#6#9#
# # # # #
#7 1 2  #
# ### # #
# #0#8# #
# # # ###
#P#  3 5#
#########
opt 0 0 0 0 0 0
hint near 4
bad 0 0 0 0 2 2 0 0
corr n near 7
