#########
#6   4#2#
# ##### #
#   #5 G#
### # ###
#P 9 7#1#
# ### # #
#8#0   3#
#########
opt 3 3 3 3 0 0 3 3
hint near 1
bad 3 3 0 0 2 2 0 0 3 3 3 3
corr e near 9
