#############
#  2# # # #5#
# ### # # # #
#8 7# #    1#
# ### # # # #
#   #0 G# # #
### ##### # #
#  9 3  # # #
# ####### ###
#4     6    #
# ##### ### #
# #       #P#
#############
opt 0 0 3 3 0 0 0 0 0 0 3 3 1 1
hint near 0
bad 0 0 3 3 0 0 0 0 0 0 2 2 1 1
corr e near 1
