#############
# # #6 4    #
# # ### # # #
#   #8# # # #
### # ### ###
# #   #     #
# ### # #####
#     #5#P  #
# ### # # # #
#   #  3  #2#
# # ####### #
#7#0#1 G   9#
#############
opt 2 2 1 1 1 1 3 3 3 3
hint near 1
bad 1 1 3 3 0 0
corr w near 5
