#########
#  7 8  #
##### ###
# #P#  2#
# # ### #
#1 0#5 4#
### # ###
#3 6 9 G#
#########
opt 1 1 1 1 3 3 3 3
hint near 4
bad 1 1 1 1 3 3 0 0 3 3
corr e near 9
