#########
#5   G#2#
##### # #
# #8#9 1#
# # ### #
#3#P 0 6#
# ##### #
#  4   7#
#########
opt 2 2 2 2 0 0 3 3 0 0
hint near 2
bad 2 2
corr keep going
