#########
#2#G 3 5#
# ### ###
#1# #6  #
# # ### #
#P#0 4 9#
# # # # #
#7  #8# #
#########
opt 1 1 2 2 0 0 2 2 2 2 0 0 3 3 0 0 3 3
hint near 2
bad 1 1 2 2 0 0
corr keep going
